a, an	wį, wįxce
abalone	hcúke
abandon someone	kihkoopse, ohkíðe
abdomen	hcéze, wánǫbréoožú
abhor	íisi
abnormal in appearance	éžixci 
abode	ohcíle
abound	ochí
about (i.e., 'almost', as in 'about asleep'), about to	ðóha
above	mąšíhta
above: be ~ others	álįįha
above: go, be, or place something ~	ámąši
above: place ~	mąšíhta
above something else	ámąši
abroad	níimąse
abrupt, abruptly	óhesaži
absent: be ~	ðįké
absurd	ókaaɣeįke
abundance	óše
abundance: disorderly ~	táatą ochí
abundant: be ~ in quantity	óše
accept	iiną́hi
accompany	žóle
accomplish a task for someone (especially drumming for someone else's singing in a peyote meeting)	áwaši
ace (in a deck of cards)	ohką́cilą
achieve success for someone	ðáalį kšíðe
acorn	hposú
acquainted: be ~ with	ípahǫ
acquainted: get or become ~ with each other	ðótahkiðe
acrid smell	zą́zi
across	áðuuhta
act (noun)	ók'ą 
act a certain way	mąðį́
act like	íkǫskahkíðe, ók'a
act unsuitably	ók'a eži 
act with rectitude	óðohtąhkiðe
activate by pushing on	paaɣí 
active	wahtóke
add a little more to	wéhuužį
add in cooking	oðóhkihą
add items to cooking	oolą́
address as friends and relatives, address with respect	wahǫ́į
adhere to	ásta
adjacent	páskuha
adjourn	panáa
administer medical care to someone	šcéðe
admire	óžo áži
adulthood, adults	nǫ́ǫ
advance: in ~	hpahą́le
advanced age	nǫ́ǫ
affect a person	omą́ðį
affected: have one's body ~ by peyote	mą́hkažóika
afraid	ðą́ące óðisąha, ðą́ące ósai
afraid: be ~ (of)	nǫ́ǫhpe, onį́žį
afraid: be ~ of	íinǫǫhpe
afraid: something to be ~ of	nǫ́ǫhpewaðe
African American	mįhkása, mįįása, níhka sápe
after	álįįha
after the present event	ákahahta
afternoon	mį́įðóhta ðiišta
afternoon: late ~	mį́įhpapo
afterward	álįįha
afterward (after the present event)	ákahahta
afterward (following, next)	áhkiha
again	aðóoha, ši
again and again	šíną
against: be ~	ížoši
against: place vertically ~	álą
against all odds	ðąącháži
ago	haašíhta
ago: a long time ~	kaahúuža
agree, agree with	iiną́hi
agree with something	íištą
ahead	kootáha
ahead: go ~	mąðį́
ahead: go ~ with something	ékiǫ
aid (verb)	óhką
air	htaacé
airplane; ride or fly in an ~	kį́į
alcohol; drink ~	waðáahtą
alcoholic beverage	hpéecenii
alert	wahtóke
alight (from)	ósi, owísi
alight from (e.g., a vehicle or a horse)	wísi
alive: be ~	ní
all	záani
all: that's ~	kaašéną, kaašǫ́įke
all day (long)	hą́ąpa záani
all night: stay ~	žą́ą
all other things	táatą éžiški
all over, all paths and directions (e.g., children running off in all directions)	háaški
all right	škaškáða
all the time	háachi, štą
all the world, all the universe	niǫhta záani
allow someone to do something	kšiðe
allow to live	níðe
almost	ðóha, hóni
alone, be alone	éwažį
alone, leave ~ (a sitting person or thing)	šǫ́įkšeðe
alone, leave ~ ! (a command)	šǫ́ ðíe
alone, leave it ~	kaašǫ́e che
along: leave ~ without bothering, touching, or otherwise disturbing	šǫ́cheðé
along, alongside	páskuha
along a path	ha
along that way	ée htáha
already	ðiištą́
Alred: Jo Ann Shunkamolah ~ (personal name: Looking Only at Her)	eeną́tǫįpe
also	éški, ški, -škitą
always	háachi, íkiha, kaašǫ́e, ną [ITERATIVE], šǫǫšǫ́we, štą
always did	nąpe
always late	ókxąži
amen	kaašéną
among: be ~	oðízą, omą́ðį
among: be ~ a group of people	omą́ðį
among: be ~ others	oðízą
among: mixed ~	íwihe
amount: large ~	huuhtą́ka
amount: small ~	hépežį
amount: small ~ (approximately half a container)	hépe
amount: small ~ (not quite filling a container)	ohépe
amusing	wah́ohota, wahóta
amusing person	wah́ohota
ancestors	mǫ́pše
ancient	kóoci
and	kóe, pátą
and (in addition)	ški
and (in numbers only)	éci
and then	káakǫ tą,kaðǫ́, kóe
angel	áahualįį
angle	paaɣó
angry	wažį́ hpíiži
angry: be ~	lǫ́ǫ
angry: be ~ at someone	ohkížį
angry: be ~ at someone or at each other	hkížį
angry: be ~ with	ihkížį
angry: become or get~	óžį hpíiži
angry: feel ~ at	hkížį
angry: make someone ~	ðúulą, wažį́ hpíiži káaɣe
animal	wacúhta
animal sounds: make ~ (moo, bark or howl, sing [as a bird], quack, etc.)	hóo, hóohtą
ankle	híihką
announcer	wacípxaį
annoyed: be ~ by	áalake
annually	omą́įhka wį hieną
anoint with	stáðe
another one	éži wį
ant	žápuška
anus	įléha
anxious: be ~ for	íhice
anxious: feel ~ about	óðąąceši [LFD]
any	tóa
any other thing	táata, éžiški
anybody	howaðéeški, pée
anyone	pée,́ wį
anything	howachéeški, táatą
anything, anything else	táatą éžiški
anything at all	táatą howachéeški
always late	ókxąži
amen	kaašéną
among: be ~	oðízą, omą́ðį
among: be ~ a group of people	omą́ðį
among: be ~ others	oðízą
among: mixed ~	íwihe
amount: large ~	huuhtą́ka
amount: small ~	hépežį
amount: small ~ (approximately half a container)	hépe
amount: small ~ (not quite filling a container)	ohépe
amusing	wah́ohota, wahóta
amusing person	wah́ohota
ancestors	mǫ́pše
ancient	kóoci
and	kóe, pátą (often not overtly expressed in Osage)
and (in addition)	ški
and (in numbers only)	éci
and then	káakǫ tą,kaðǫ́, kóe
anew (see inceptive prefix)	
angel	áahualįį
angle	paaɣó
angry	wažį́ hpíiži
angry: be ~	lǫ́ǫ
angry: be ~ at someone	ohkížį
angry: be ~ at someone or at each other	hkížį
angry: be ~ with	ihkížį
angry: become or get~	óžį hpíiži
angry: feel ~ at	hkížį
angry: make someone ~	ðúulą, wažį́ hpíiži káaɣe
animal	wacúhta
animal sounds: make ~ (moo, bark or howl, sing [as a bird], quack, etc.)	hóo, hóohtą
ankle	híihką
announcer	wacípxaį
annoyed: be ~ by	áalake
annually	omą́įhka wį hieną
anoint with	stáðe
another one	éži wį
ant	žápuška
anus	įléha
anxious: be ~ for	íhice
anxious: feel ~ about	óðąąceši [LFD]
any	tóa
any other thing	táata, éžiški
anybody	howaðéeški, pée
anyone	pée,́ wį
anything	howachéeški, táatą
anything, anything else	táatą éžiški
anything at all	táatą howachéeški
anything on doesn't like	kihǫ́ǫži
antique	kóoci
anyway	óðąži
apart: be ~	kiðahapa
apart: pull or tear ~ (e.g., a tree limb from the trunk)	ðupáxa
apart from anyone else	ohką́ci
appear	hcį́į, íðǫpe, wahcį́į
appear a certain way: make one ~	tǫ́pewaðe
appear so	tǫ́pewaðe
appear suddenly	wahcį́į
Appear Suddenly to Them (personal name)	wakáahcįe
appendix (the internal organ)	šúpe
appetite: have no ~	wanǫ́brazi
apple	hką́ące
apply	hką́ące
apply (a substance such as ointment, grease or cream)	stáðe
apply makeup	įcé káaɣe
apportion	íhkilai
appreciative	óweena
appreciative: be ~ (of)	wéeną
approach	mąðį́
appropriate	ðąąché, ékǫ
appropriate: be ~	íhta
appropriately	ékǫ
approve of	iiną́hi
apricot	hką́ące zi žį́
April	mį́įǫpa šápe, mį́įǫpa wetóopa
Arapaho (tribe or tribal member)	aį́paxo
arbor	áhcihtą, wažáihci
arbor house: long ~	haaskáhci
arch of the foot	óski, síioski
area: cleared off ~	oštá
argue on behalf of (e.g., as an attorney)	áhkie
argument	óie, taaké ie
arise (from a bed or chair)	hpaahą́
arm	áa
armband	áahkǫ, áapiolą
armed forces	áhkita, áhkita omą́ðį, taakě oną́ąžį
armed person	áhkita
army	áhkita, áhkita omą́ðį
around	okáwįɣe
around: be ~ close	ákiɣe
around: go ~	kǫ́kǫe
around: go, pass, or walk ~	ákiɣe, ápše
around: go ~ something	íðišąha
around: move or be all ~	ákiɣe
around: turn oneself ~	ámąhta hkilíikoįɣe, hkilíisą
around: turn someone/something ~	ðiihkóįɣe
around: twist ~ (e.g., a crepe paper steamer)	ðusą́sąwį
around(as in drive around, turn around etc.)	wįɣe
around(e.g., a house, tree, tipi, drum)	ápetxa
around the edge(e.g., of a pond)	ákiɣe
around this way	ðeekáiha
Aroused by Something That Suddenly Appears (personal name, referring to a deer suddenly looking up)	wakáahcįe
arrange	ðuustáko
array (verb) (multiple items)on top of something else	ážu
arrest (put someone in jail)	hą́ąnahpazé oolą́
arrive back here	alí
arrive back there	akší
arrive here	achí
arrive here with (motion accomplished)	aðįachi
arrive home	akśí
arrive home here (motion accomplished)	alí
arrive there (motion accomplished)	ahí
arrow	mą́ą́
arrow shaft	mǫ́ǫse
arrow shaft tree	mǫ́ǫsa hu
artery (blood vessel)	hką́, lušúpe
arthritis	wahúni
artichoke	hpǫ́ɣe
as (see because)	
as	šq́
as...as	ékǫ́
as well	śki
ashamed, feel ashamed	iišcéwai
ashes	níixoce
ashtray	níixócoožu
ask a favor	waatá, waší
ask a question	iðǫɣe
ask concerning one's own people or things	ilǫ́ɣe
ask folks to work for one	áwawaši
ask for	tá
ask for (as a loan), ask for something to use it	ootá
ask permission	íihǫ
ask someone questions	ðuupxáðe
ask someone to do something	ée, íihq
ask someone to help out	waší
aspirin or any other kind of medicine	mąhká
ass, asshole	įléha
ass (donkey)	nąąhtą́htąą
assassinate	cˀéðe
assemble (as for a council)	kiistó
assign a name to something or someone	ðaacé
assist	óhką
assistant chief	kahíke ókˀą, kahíke otxą́
at	ci, ki
at (something lying or spread out)	kši
at a time (e.g., a bit at a time, two at a time)	nąðé
at least	našǫ
at rest	škaškáða
at that place or time: be ~	ecí
at this time	ðetxą́ci
attend	oną́ąži
attend to	óðąąceši
attention: act of paying ~	nąąɣúce
attorney	wáhkie
attractive	ðáalį
augment	htą́ą
August	hlaazípe, mį́įǫpa hkíetoopa
aunt: maternal ~ (specifically, mother's older sister)	
my mother's older sister	iiná, iiną́htą
your mother's older sister	ðiihǫ́htą
his/her mother's older sister	iihǫ́htą, iihǫ́
aunt: maternal ~ (specifically, mother's younger sister)	
my mother's younger sister	iinážį, iiną́
your mother's younger sister	ðiihǫ́hžį
his/her mother's younger sister	iihǫ́žį
aunt: paternal ~ (i.e., sister of father of male, either older or younger)	
my father's sister	wihcími
your father's sister	ðihcími
his/her father's sister	ihcími
authoritative, authority	wahtǫ́ka
authority: one with ~	totą́ha, wahtǫ́ka
automobile	éwažį ną́ąke
automobile tire or wheel	hcéðe
autumn, in the autumn	htąątą́
avoid something	íðišąha
awaken (intransitive)	íihkíðe, -xi
awaken (transitive) by foot	nąąxí
away: a short distance ~	áška
away: give ~	níðe, wakˀú
away: give ~ by pressing or pushing away (e.g., the ilǫ́ǫška drum)	kaaðéešpa
away: give things ~	waníðe
away: give ~ to each other	ohkíkˀu
away: give ~ to one's own people	kíkˀu
away: giving ~	ókˀu
away: go ~	mąðį́, okábra
away: pass or give ~ (e.g., the drum at ilǫ́ǫška dances)	kaaðée
away: take ~	aðį́aðee, aðį́mąðį, ðicíze
away: take ~ from someone something of his/her own	kilúuze
away: take ~ one's own	lúuze
away: throw ~	ǫ́ǫðe
awful	hpíiži
awhile	katxą́
axe	mą́ąhįska(?), mą́ąhįspe
baby	hpáažį
baby: have a ~	wéetaðe
baby: place or put a ~ on the baby board or inside	hpáažį okˀǫ́he
baby boy	šį́tožį
baby girl	šį́mįžį
baby board	oðópšé
baby board: place a baby on the ~	hpáažį okˀǫ́he
babyhood	hpáažį
babysit, babysitting	žįkókašą
back	xáða
back: attached to the ~	oðáha
back: arrive, come, or get ~	akší, akú, alée, alí
back: bring or take ~	aðį́aksi, aðį́aku, aðį́alee, aðį́ali
back: give ~	kíkˀu
back: go ~	mąlį́
back: in the ~ of	haaší
back: some days ~	hǫpái hašíhta
back (in return, again)	ki-
back (of the body)	ną́hka
back and forth: pass or go ~	ihkílašą
back and forth movement: make a ~(as when riding a teeter-totter)	sísiąðe
backward	xáða
bacon	wašį́
Baconrind (personal name)	wašį́haa
bad	hǫ́ǫži, hpíiži, óhesaži
bad: make something ~	ðuhpíiži
bad deeds (such as bad talk or theft)	ókˀą éži
bad disposition: having a ~	ókˀą hpíiži
bad dream	ohpáza
bad manners: having a ~	ókˀą hpíiži
bad dream	ohpáza
bad manners: having ~	ókˀą hpíiži
bad medicine	mąhká hpíiži
bad reputation: of ~	nǫhǫǫ
bad shaft of an arrow	mą́ąhpiiži
bad shape: be in ~	íhpiiži
bad temper	waðilą hpíiži
bad things	ízizike, táatą hǫ́ǫžį
bad things about someone: say ~	hkiláažoži
bad weather	mą́ąhpiiži
bad words	íe hpíiži
bad words: say ~	lǫ́ǫ
badger	xóoka
badly	óhesaži
bag	óožuhaa
bag: tobacco ~	nąnúhuoožúhaa, nąnįǫ́kužu
bait someone to say or do something	ožížie
bake in an oven	mą́zeǫ́ohǫ oohǫ́
bald	stá, štáha
bald: make ~	ðuuštá, ðuuštáštai
bald head	hpeeštá, wéelišta
bald headed	wéelišta
ball (used in a game)	htaapé
baloney	tǫ́ǫpše
banana	htóžąke
bank	mą́zeskahci
banner	haawálele
bar	hpéecenii ðaahtą́ hci, hpéeceniihci [archaic]
barbecue (refers only to cooking meat on a rack)	óhkace
barbecue meat: the black part of ~	táasaaki
barbecue rack	oážu, wážu
bare: make ~	ðuuštá
bare ground	oštá
barely	tó
barely touch	ðiihcé
bark (as a dog does)	hóo, hóohtą, óhoo
bark of a tree	hį́įce, xúhaa
bark of a tree: inner ~	žąąxúha
bark of a tree: outer ~	žąą háa
barren	wéetaðaži
Bartlesville (Oklahoma)	hkáwažį htą́wą
base (adjective)	iiséwaðe
basement	mą́įhkaši
bashful	wíeži
basta!	kaašǫ́ka
bat (flying mammal)	žą́ąhpaɣe
bath house	ohíiðahci
bathe, take a bath	hiiðá
bathe: place to ~	ohíiðá
bathroom	ožéhci
bathtub	ohíiða
baubles: bits and ~	ošpéžį
bawl out	kaazą́, toníðe
be	ðį́
be alive, be in good health	ní
be characterized by	ðį́
be here	ðeeká
be here or there	ecí, ecíke (scattered)
be in, among, or throughout an area or a group of people	omą́ðį
be so	ékǫ
be there	ahí
be there, be at that place, be at that time	ecí
beads	hį́įska, tóoce ðiláace (?), wapúśka
beads: prayer ~	wíkie hį́įska
beadwork (noun)	hį́įska káaɣe
beadwork: do ~	hį́įska káaɣe
bean vine	hǫbrį́ hi
beans	hǫbrį́ke
beans: green ~	hǫbrį́ke, hǫ́brįke htóho žį
bear (especially black bear)	wasápe
bear cub	wasápežį
beard	hį́į, į́hį
beat (conquer)	ohí
beat (e.g., a drum)	kaaštá
beat of a drum, beating sound	hcíce
beat someone in a race	káaxa
beat things (such as a drum)	óchį
beat up	óchį́
beautiful	ðaalį, ohtáza
beaver	žąąhpáto, žápe
because ('because' is often not expressed directly but implied by the logical or pragmatic relationship of one clause to another: for examples, see under 'burn' 'some', 'be thankful, grateful, 'far')	tą ('because' is often not expressed directly but implied by the logical or pragmatic relationship of one clause to another: for examples, see under táalį 'burn', tóa 'some',wéeną 'be thankful, gratefuĺ, wéhice 'far')
become (suddenly?)	ahí
become a person	ínihkašie
become angry or mad	óžį hpíiži
become embarrassed	iizíke
become extinguished	táaži
become soft or sodden	špǫ́ǫ
bed	ážą, óžą
bed: go to ~	žą́ą
bed: have someone in ~, put someone to ~	áðižą
bedclothes, bedding	omíže
beef: head of ~	hcéeska
beer	hkáwaceženii, níi ápuɣe [archaic]
beet	tóole žúe
beetle	walúška háa šooká
before (adverb)	haašíhta
before (ppn)	žišǫ́
beggar	waatášta
begin	hínąąžį
begin to	ahí
beginning: from the ~	hpahą́le
behave	óðohtą
behave oneself	óðohtąhkiðe
behavior: good ~	óðohtą, óðohtąhkiðe
behavior: in regard to ~	taa-
behind	haaší
behind: be ~	oðáha
behind: leave ~	ǫ́ǫðe
behind someone's back: ~	nąlǫ́ǫha
belch	íkˀo, wawékˀo
believe	ažį́, éðe
believe regarding someone	ažį́
belittle	ðaažóži
belittle someone	hkiláažoži
bell	íikaahtamą
bell: ring like a~	kaahtáama
bell: ring the ~	ðuuhkáamą
bells (such as the ones dancers tie around their legs)	mą́zeštahižį
belly	hcéze
belong to (a group)	oðízą
belong to him	íhta
belong to someone	íhta
belong to them	íhta, íhtaapi
beloved	óxta
beloved: someone or something ~ (such as a favorite child)	óðoxta
below	oðúluha
belt	íhpią
belt: men's dance ~	íišupe
belt: woman's yarn ~	hceehį́į
belt (worn by men outside a blanket)	íišupe
belt (worn by men with dance clothes or outside a blanket)	íhpią
beneath	oðúluha
bend: make ~ (e.g., a tree branch using the hands)	ðiizó
bend down	paacˀį́
bend one's body part (e.g., leg or arm)	ðuušǫ́
bend one's own (body part or possession), bend oneself	líizoke
bend over	kaapáacˀį
bent over (as a person, a tree, or a hooked staff)	cˀįša
bent over (referring to a human body)	cˀįxa
berry (inedible)	pazó
beside	páskuha
beside each other	hkiðé
best: be the ~ (above all others in a certain aspect)	ǫchí
best: do one's ~	íkˀuce, waašką́
best everyone in a game	óhi
best someone in a game	ohí
bet (noun)	óžokˀa
bet: make a ~	óžokˀa káaɣe
better: get ~ (in regard to illness)	kiní, kitą́he, kítąhe
between	ohtą́ną
bewitch or "witch" someone	kilǫ́źe
beyond	kootá, kootáha
beyond a certain point	kootáha
beyond another thing	áhkiha
Bible	waléze sápe
bicycle	hcéðe álįį, hcelį́ álįį
bid (noun)	oðáake
big	htą́ą, htą́ka, lą́ąðe
big goose or big duck	míɣa htą́ka
bill (paper money)	htaną́kˀa, htaną́kˀa mą́zeska
billfold	mą́zeskaoožú
bind (verb)	paaxcé
bind (as a blanket)	pašǫ́we
bird	wažį́ka
bird: game ~	míɣa
birth	wéetaðe
birth: give ~ (to)	iitáðe
birthday: have a ~	iitáðape ékitxą
birthing: be ~	waníe
biscuit	wacúe ðutáahpa
bit: a ~ (of)	hépe huužį
bit: a ~ (slightly)	ékǫ
bit(fragment)	kašpé, ošpéžį
bit of a whole coin (twelve and a half cents)	kašpé
bitch (female dogs)	šǫmį́įka
bite (verb)	ðaaxtáke
bite folks, bite people	waðáaxtake
bite into small pieces	ðáaxǫ́ke
bite oneself	hkilaaxǫ́
bits and baubles	ošpéžį
bitter	hpá
blabbermouth	táatąžį́ ški oðáake
black	sápe
black dog	šǫhtą́ą sa
Black Dog (personal name)	šǫ́ke sa
black person (African American)	mįhkása, mįįása, nihka sápe
black person: little ~	sáežį
black walnut	htákue
blackberry	waskúe sápe
blackhawk	letǫ́sape
bladder	céženiioožú
blanket	haxį́, mį́, omíže
blanket: man's ~	óhkihpaache
blanket: saddle ~	wákaśtǫ
blanket: woman's ~	mį́waapaache
blanket folded to cushion a seat	wákaštǫ
blanket wrapped around like a skirt	wáakipetxą
blazing star (Liatris punctata)	mąhká saakí
bleed	wapį́
blend	oðóhkiðe
bless	ðakˀéðe, ðuðáalį
bless: use to ~	íištope
bless: use to ~ oneself	íistahkiðe
bless or give a blessing with the hand	ðistópe
bless with	íista,íištope
blind: be ~	įįštá wawéeðeži
blind (covering, e.g. for a window)	akáaspe
blink (verb)	ðupˀį́ze
blink at each other	iištáðe ahkíliitože
blink repeatedly	ðupˀį́pˀįze
blink the eyes (at)	iištáðe ðiitóže
block someone's way	oðóšimąðį
blood	wapį́
blood vessel (vein or artery)	hką́, lušúpe
bloom (verb)	opáaɣa, paaɣace
blossom (verb)	paaɣace
blossom on a tree	žą́ąlaa
blow (transitive)	ðaažóce
blow (as one's nose)	píɣą
blow inside, into, or on (e.g., a fire in a fireplace)	opíɣą
blow on	ðaažóce
blow on something	píɣą
blow with force (as in blowing one's nose)	kaaží
blowing: by ~ (as on a fire to get it started)	pi-
blue	htóho
blustery	htaacé hpíiži [LFD] board: baby ~ oðópše
boat	páce
boating	pacíolįį
bobcat	įžį́akika, lį́xa
body (human)	žúoka
body odor	žą́xta
boil(noun)	ðéskali
boil(as food boils when cooking)	ápuɣe
boil dry, boiled dry	táapuze
boil over	táapuɣe
bois d'arc	mį́ceštá hu
bone	wahú
book	waléze
boot	hǫǫpésce [LFÐ]
born	iitáðe
borrow	ootá
boss (n, v)	oðówaðe, wakáaɣe
boss: be a ~	oðóðe
boss: be ~ of (e.g., an event)	oðówaðe
boss an event	oðóðe, óohkihą
boss of them	ðǫǫpá, éeðǫǫpa
both of us	éeðǫǫpa
bothered: be ~ by	áalake
bottle	oožú, óožu
bottle: pop ~	niikáapxokeoožú
bottom (buttocks)	įléha
bounce up (as in a car or wagon)	kaamą́šąšie
bouncy (as in rough ride)	kaamą́šąšiebow (noun) mį́ce
bowel movement: have a ~	žé
bowl (noun)	hį́įce, htáanieoožú, oožú
bowstring	mį́cehką
box (noun)	žą́ąhkoke
boy	šį́tožį
bracelet	áahkǫle
braid (noun)	hpáxįįsą
braids	héðǫǫpa
brain	waðílą
branch: tree ~	žą́ą káxa
branch (of a tree or a stream)	káxa, káxa žį
branch of a tree: broken ~	žą́ąkaaxǫ́
branches: small ~	žą́ąxežį́, žą́ąžį
brand (verb)	pážahta
branded (with a notch or cut, etc.)	žáhta
brave	wašóše
bread: light or leavened ~ (wheat bread, as opposed to corn bread)	watáahą
bread (or 'piece of bread'; any kind of bread: cornbread, wheat bread, etc)	wacúe
break	kaaléke, xǫ́
break a long object by pushing	paaxǫ́
break by biting	ðaaxǫ́
break by foot, break with the foot	nąąxǫ́
break by hand	ðiixǫ́
break by mouth	ðaaxǫ́
break by striking (a long object such as a stick)	kaaxǫ́
break down	pixǫ́
break into pieces by mouth	ðaaxǫ́ke
break into two parts	ðiixǫ́
break off (a large object such as a stick)	kaaxǫ́
break off a long item by using the hands(e.g., a limb, sofa, car antenna)	ðiixǫ́
break off by pushing(e.g., a limb)	paaxǫ́
break off someone's(e.g., a limb)	kíðiixǫ́
break one's own) e.g., a body part)	kiixǫ́, liixǫ
break one's own by mouth	láaxǫ
break one's own by shattering	kíleke
break someone's (e.g., a body part)	kíðiixǫ
break something of one's own mouth	láaxǫ
break up (e.g., a meeting)	panáa
break with the hands (e.g., a dish, an egg, a light bulb, a window)	ðuuléke
break wind	ðiipíɣą
break wind (with a small noise, by letting the air out slowly)	ðižíce
break wind noisily	ðibrį́ɣa
breakfast	kaasį́exci wanǫ́bre
breakfast food	kaasį́exci ónǫbre
breast	paazé
breath: run out of ~ from	íkaske
breath: short of ~	hehé
breathe	ónie
breathe hard	heháha
breathless: become ~ from	íkaske
breechcloth	xíðaxa
breechloading shotgun	wahóohtą opáaxǫ
breeze	htaacé
briars	waxáka
bridesmaid: have as a ~	íðuɣe
bridge (noun)	žą́ąkaaxǫ́
bright	skáha
bright colors	hį́į́
bring	akú
bring back here (motion underway)	aðį́aku
bring back here, bring back home (motion accomplished)	aðį́ali
bring back something that belongs to oneself	aláðįku
bring back there (motion accomplished)	aðį́akši
bring here (motion accomplished)	aðį́achi
bring here (motion underway)	aðį́ahu
bring home (motion accomplished)	aðį́akši
bring the parts of a whole together with pressure, bring components into contact	ðiiskíke
bring there (motion accomplished)	aðį́ahi
bring up (rear or raise)	nǫ́ǫðe
Bristow: Robin ~ (personal name)	wažážemį́įhcexį
broad	bráaða, lą́ąðe
broadcloth	haaštáha
broke (without money)	xǫ́
broken	xǫ́
broken: be ~	kaaléke, kaaxǫ́ (when useð with continuative aspect marker akxa or apa), xǫ́
broken heart	ðą́ące ðuusáaki, ðą́ące xǫ́
brooch	wápaɣa
broom	wékaacuxe
broth	htaaníi
brother (specifically, older brother of a female)	
'to my older brother' (speaker is female)	wihcį́to
'your older brother' (addressee is female)	ðihcį́to
'her older brother'	ihcį́to
brother (specifically, older brother of a male)	
'my older brother' (speaker is male)	wižįðe
'your older brother' (addressee is male)	ðižįðe
'his older brother'	ižį́ðe
brother (specifically, younger brother of a female)	
'my younger brother' (speaker is female)	wisǫ́ežį
'your younger brother' (addressee is female)	ðisǫ́ežį
'her younger brother'	isǫ́ežį
brother (specifically, younger brother of a male)	
'my younger brother' (speaker is male)	wisǫ́ka
'your younger brother' (addressee is male)	ðisǫ́ka
'his younger brother'	isǫ́ka
brother: baby ~ (of a female)	kxáhpą
brother-in-law (specifically, brother-in-law of a male)	
'my brother in law' (speaker is male)	wihtą́ha, htą́ha
'your brother in law' (addressee is male)	ðihtą́ha
'his brother in law'	ihtą́ha
brother-in-law (specifically, brother-in-law of a female)	
'my brother in law' (speaker is female)	wišíkˀe 
'your brother in law' (addressee is female)	ðišíkˀe
'her brother in law'	iśíkˀe
brow	hpée
brow: smooth ~	hpeeštá
brown (adjective)	zíhi, zízi, žíhi
brown: light ~ (like the color of elk hide)	ópxą, hį́į ekǫ́
brown (become brown by application of heat)	taazíhi
brown (i.e., to brown food)	taazíhiðe
browned	taazíhi
brownie (elf)	míalǫška
brush (verb)	kaaɣú
brush: wire ~	wákaapše
brush (for the hair)	wékaapše
brush arbor	áhcihtą, wažáihci
brush someone's hair	kípše
brush the mane or coat of an animal	kípše, wákaapše
buck	htáa, htáa htą́ka
bucket	céɣe
buckeye tea	htáška hí
buckskin	htaaháa
buckskin dress	haaská
bud on a tree	žą́ąlaa
buddy	hcošpá
buffalo	ðóxe, hcée
buffalo: small ~	hceežį́
buffalo: young or small male ~	hceetóežįká
buffalo calf: unborn ~	hceežį́
Buffalo Chief (personal name)	ðóxe kahíke
Buffalo Clan	ðóxe
buffalo horn(s)	hcehé
bug	walúška
bug with thick outer layer of exoskeleton	walúška háa šooká
build	káaɣe
build a fireplace or fire	océðe
build for oneself	hkihkáaɣe
bulge	hpá
bulk, in bulk	bróka
bull	hceeskátóoka
bun (woman's hairdo)	hpáxį ðuutáahpa
bunch: a whole ~ of	huuhtą́ka, huuwáli
bundle: gather and tie in a ~	paaxcé
burden: be a ~ to someone	ówǫ káaɣe
burdened: be ~ (e.g., with excessive woe)	íibrąxcį
burgundy (color)	žúuce sápe
burial ground	óxe mą́žą
burial place	óxe
burial stick (red stick put into a coffin at the head or foot, made of special wood)	hką́ące žąą
burn (verb)	osái, táaðįke káaɣe, táalį
burn cigarettes (as in a peyote meeting)	osái
burn down, burn up	táaðįke káaɣe
burned	táalį
burned meat	táasaaki
burning	íwili
burp	íkˀo, wawékˀo
burro	nąąhtą́htąą
burry	waxáka
burst	kaapxóhke
bushy head	héxpa
business: run a ~	oðówaðe
busy	ówǫ
busybody (refers to someone who is into everything)	ókˀąštą
but	ąži, kóe, ną
butcher (noun)	wapáse
butcher (verb)	hpáce, wahpáce
butter	paazénii wéli
butterfly	kį́įkįįežį
buttocks	įléha, ǫ́pe
button	oðíiną
button-snake-root (liatris punctata): dotted ~	mąhká saakí
buy	ðuwį́
buy for one's own (people, family)	lúwį
buy for oneself	hkíluwį
buy for someone	áðuwį, kíðuwį
buy from someone (something that belongs to that person)	kíðuwį
buy something of one's own (buy back)	lúwį
buy stuff with something	wéðúwį
buy things	waðúwį
buy with	íðuwį
buzzard	héka
by: pass ~	ákiɣe, ípše
by car	éwažį ną́ąke, oðihtą olį́į
by extreme of temperature	táa-
by foot ~ go ~	mąðį́
by hand	ðu - 
by heat or cold	táa-
by means of	í-
by mouth	ðaa-
by oneself	éwažį, ohką́ci
by striking	kaa-
by way of	ha
cabbage	wéelihtąą
cable	mą́ze
cache	nąlǫ́ǫhkile
Caddo (tribe or tribal member)	hįįšá
cafe	owánǫbrehcí
cake (e.g., birthday cake)	wacúe skúðe
calf: unborn ~	hceežį
call: phone ~ (noun)	mą́zeie
call by name (verb)	ðaacé
call by phone	mą́zeie híðe, ohkíe
call by phone: have something ~	mą́zeohkíhkie hukšíe
call each other names	hkílǫ(lǫ)
call folks names	walǫ́ǫ
call for folks (verb)	wapą́
call loudly	hóosaaki
call names	lǫ́ǫlǫǫ
call on someone's name	ðaacé
call one's own, call one's own by name	láace
call one's relative(s)	kíhpą
call someone a bad name	lǫ́ǫ
call to ask or summon s.o to attend or appear before others	kípą
calling songs	wapą́ waaðǫ́
calm (verb)	ðuuštáka
calm, calmly	škaškáða
calm (a person's ways or the weather)	štáke
camp (verb)	ahcí, hcí
can or other container for soda pop	niikáapxokeoožú
Canadian person	įįštáxį
candy	žąąníežį
cane	íisa
cannot	ðąącháži, ðuucˀáke
cannot understand	kíopxaži
cantaloupe	įįštáxį sáhku
cape	ákahamį
car	oðíhtą
car, by car	éwažį ną́ąke
car door	oðíhtą heižé
card: greeting or gift ~.	íe ðáalį žį
card: lead or play a ~ (in a card game)	ðée káaɣe
card game.	htaną́kˀa kˀǫ́
cardinal (bird)	wažį́žue
cards	htaną́kˀa kˀǫ́
cards: play ~	htaną́kˀa kˀǫ́
cards: playing ~ (noun)	htaną́kˀa, htaną́kˀa ðiihíce
care: have a ~ with regard to something or someone	íinǫǫhpe
care: take ~ of	átǫpe, ðakˀéðe, okášą, okáše, wanáše
car: take ~ of a meal oneself when asked to do so	óohkihą
care: take ~ of a task or an event	oðówaðe
care: take ~ of oneself	óhkihkaše
care for kids (babysit)	žįkókašą
care for oneself	ohkíežą
care for the sick	húheka okášą
careful: be ~ with	íinǫǫhpe
careful: not ~	íinǫǫhpaži
caress	íišeįka
caress one's own	íikišeįka
carousel	kǫ́kǫe
carpet	omíže
carrot	tóoleži
carry	aðį́aðee, į́, kˀį́, kˀį́ahi
carry on in a certain way	ahkílaðį́
carry on the back	kˀį́
carry one's items, carry along one's items	aláoį́
carry one's own	aláðį́
carry oneself	ahkílaðį́
carry piggyback	ðuškápa
Carrying-and-Wailing (personal name)	wáį́ɣaaké
carrying the charcoal (mourning dance)	wašápe aðį́
cash payment	wahkílae wakásupe
cast a spell on someone	kilǫ́že
castor oil	wéli mąhką́
cat	ilǫ́eži
catch	oðį́įke
catch on something	íhkowa
categorize	hpahíke
caterpillar	wáxta
catfish	htóze
Catholic (noun, adjective)	šǫmį́hka
cattle: head of ~	heéeska
caught on something: get ~	íhkowa
causative markers	ðe, hkiðe, káaɣe, kíðe, kšíðe, kšíɣe
cause oneself ill or harm	hkilúhpiiži
cause oneself to be or do	hkíðe
cause something to be a certain way	káaɣe
cause to be for someone	íkikaaɣe
cause to be or get lost	oxpáðe káaɣe, oxpáðeðe
cause to fly out in pieces or splinter	paaśike
cause to go	ðéeðe
cause to smell, as in making cedar smoke for a cleansing or blessing	oðíbrą
cedar	xǫ́ǫce
cedar tea	xǫǫcénii
cease (transitive)	kaaštą́, kaakǫ́ną, káaɣe
cellar	mą́įhkaši
cemetery	óxe mą́žą
censure (verb)	kaazą́
cent	waðáawažį́
center	ohką́ska
center: at the or in the ~	mąché, ohką́ska
center: toward the ~	mąchéhtaha
cents: five	waðáawa sáhtą
cereal	kaasį́exci ónǫbre
ceremonial dances of the Osages	ilǫ́ǫška
certain way; live or be a ~	ðį́, mąðį́
certainty of a future event	ðée hta ché
chair	áalįį, álįį
chaise longue	álįįscee
challenging	wahcéxi
change (transitive)	ðúeži
change: make or make a ~	íhkihkaį káaɣe
change (as the weather)	šką́
change (money, coins)	íhkihkawį, ošpéžį, waðáawažį
change one's mind	waðílą kikáaɣe
change one's ways	hkilíisą
change (intransitive)	íhkihkawį káaɣe
changeable	éžixci
characteristics: personal ~	ókˀą
charcoal accompanying them (ceremonial title)	wašápe aðį́ wažówale
charge: be in ~ of	oðóðe
charge: in ~	oðówaðe, óohkihą
charge: take ~ of	ókašą
charred meat	táasaaki
chart of land.	mąžą́waleze
chase (verb)	ðuxí, olé
chase away	olé
chastise	kaazą́
chauffeur	waðíhtą wakáaži, wakáaži
cheap	ómąhka
check a horse's forward movement	oðíitą
cheerful	ókˀą ðaalį
cheese	paazénii saakí, paazénii wéli saakí
cherish each other	óxtahkiðe
cherish one's own	kíoxta
cherished	óxta
Cherokee (tribe or tribal member)	šaáke, šálaki
chest (box)	žą́ąhkoke
chest (of the body)	mą́ąke
chew	ðaaškíke
chicken	súhka
chewing gum	mį́įhtǫeli
Cheyenne (tribe or tribal members)	htáaceomą́i
chicken: banty (bantam) ~	súhka saaki
chicken: prairie ~	mǫ́nǫį
chief	kahíke
chief: be ~ (over a people)	kíhike
chief-to-chief (succession of hereditary chiefs within a family)	opxą́pxą́
child, children	žįká, žįkážį
childbirth	wéetaðe
childcare	žįkókašą
childhood	žįkážį
childless	wéetaðaži
children: take care of ~	žįkókašą
children in their teens	hcéka nǫ́ǫ
chin	ðéepa
chip (noun)	ošpéžį
choke from	íkaske
choke with the hands	tóoce oðį́įke
choker (necklace)	wanǫ́pˀį
choose	ðuuzé, hkíhpaahi
choose people (or things?)	wapáahi
chop (verb)	ðilǫ́že
chop by striking with	íkaase
chop down, chop up (e.h., with and axe or a knife)	kaasé
chop with a blade (e.g., wood for a fire)	kaasé
chore	ówǫ
chorus (female)	oðáazo
Christmas	wahkǫ́ta ižį́ke íikitaðe, xǫǫcéhu káaɣe hǫ́ǫpa
chubby	lą́ąðehtą
church	waatáihci, wahkǫ́tahci, wíkiehci
church: little ~	wíkihcižį
church bell	íikaahtamą
church house: Native American ~	hcipóɣa
cigarette	nąnį́ǫpažį
cigarette: roll a ~	nąnį́ǫpa káaɣe
circle around	ákiɣe
circular	táahpa
circulate	ápše
circus	ówatoį
clan	htą́wąla, inihkašie
clan subdivision (of Deer clan)	nǫ́pxata
clap (e.g., the hands)	nąsą́sąwa
clarify	wáðaaska
class	íkˀuce, walézeáace
class: what ~ of	táatą
classify	hpahíke
clatter (verb)	htáhtaze
claw	šáake
clay	mą́įhka
clean (verb)	ðuuwásu
clean, cleanly	wasúhu
clean (e.g., the house)	ðicíze
clean off	púɣa
clean off by wiping	púkxa
clean oneself	hkilúuwasu
clean talk	íe wasúhu
clean up	ðuuwásu
cleanse	ðuuwásu
cleanse or be clean by heat or cold	taasúhu
clear (adjective)	ská, skáha, stá, wasúhu
clear: make ~	wáðaaska
clear (as the weather)	ðáalį
clear language	íeska
clear sky (as after a storm)	hkéðo
clear speaking	íe wasúhu
clear words	íe waská, íeska
clearance (space)	ohtą́ną
cleared off area	oštá
clearly	skáha, ská, wáðohtą, wasúhu
clearly: speak ~	íe ðáawaska, íeska wáðaaska
clear-minded	ną́ąɣeska
clicking noise against metal (as made by a typewriter)	mą́ze htáhtaze
clicking sound	htáahtaze
cliffs: dwelling on the ~	hpasú olį́į
climb, climb onto (by using the arms)	áace
climbing (by wrapping around?)	átxą
clock	mį́įoðaake
close (verb)	kaasį́ce
close (e.g., one's eyes)	ápisą
close (near), closeby	áška
close by grasping	áðiihtą
close by pulling	áðiitą
close by zipping, tying, fastening, or buttoning	oðíiną
close on	ákaasįce
close one's eyes	ðupˀį́ce
close suddenly or by striking	kaasį́ce
closing of a prayer	kaašéną
cloth	háa, haaská
clothe oneself with	íwehkilį
clothes	haaská, ohkúlą, wéhkilį
clothes: Osage ~	wažáže wéhkilį
clothes: put on ~(one's own)	wéhkilį okíhpaahą
clothes: put ~ on oneself	óhkioolą́
clothes: take ~ off (another person or oneself)	ðuušáwa
clothes: wash ~	wasíiški
clothes: wash ~ for oneself	hkilíiški
clothing	haaská
clothing: any item of ~	wéhkilį
clothing: relieve s.o	of ~ ðuuštáke
cloud, cloudy	mą́xpu
clown	waðíhohota, wahóhota
clubs (suit in a deck of cards)	cˀáaži
coat	ákahamį, mǫkápo, wéhkilį
coax someone to say or do s.t	ožížie
cobbler	hǫ́ǫpekaaɣe
cock: turkey ~	áahu mą́ðį
cockleburs	waxáka
coffee	mąhkása
coffer	žą́ąhkoke
coffin	óxe sápe
coin	mą́zeska
coins	ḿą́zeska zí, ošpéžį, waðáawaži
cold	níni
cold: be or fell ~	níhce
cold: have a ~	hóxpe ǫ́ǫ
cold (used of weather)	níwahce
cold with sniffles and fever (noun)	hóxpe
collect together (many small scattered things)	paahí
colon	šúpe
color bright colors	hį́į
Comanche (tribe or tribal member)	hpá tóohka, wátoohka
comb (noun)	hpahúze, wékaapše
comb one's hair	káapše
comb s.o	's hair kípše
come back	alí
come back here (motion underway)	akú
come back with s.t	that belongs to oneself aláðįku
come by (i.e	, pass) ípše
come by (i.e	, stop in) ahí
come here: cause to ~	húðe
come here (motion accomplished)	achí
come here (motion underway)	ahú
come here with	akú
come home (motion underway)	akú
come into possesion of	okšehtą
come there (motion accomplished)	ahí
come to (after being unconscious)come to one's senses	hkilázo, iihkíðe
comfort	kiɣúhke
comfortable	hkikˀąze
comfortable: make oneself ~	hkikˀą́ze
comforting	štáke
comical	wahóhota, wahóta
comical person	wahóhota
command someone to do something	ákaaži, kaaží
commit suicide	cˀéhkiðe
committeeman	totą́ha
compete with one another	áhkihkie
complementizer	che
complete	bróka
completive markers (see noncontinuative markers)	
compress	kaaskí
conceal, conceal oneself	nąlǫ́ǫha, púuspe
conceited: be ~	óžo áhkižį
concenr: feel ~ over, be ~ed about	óðąąceši
conduct one's own or someone else's affairs	oðówaðe
conduct oneself	ahkílaðį
conference held by a group of people	hkiistó
confused: be ~	ážąį ðuucˀáke
confused, confused person	pxáðaži
congested	ocˀį́ze
congressional representative	hkiistó omąðį
congressman, congresswoman	wahkílaace káaɣe
conquer	ohí
consciousness: regain ~	iihkíðe
consecrated	xópe
consecutively	ohkíetxątxą
consider	áwaðilą, éðe, ékiðe, íðilą, waðílą
consider precious	óxta káaɣe
consider something	táatą íðilą
consommé	htaaníi
constantly	štą
consume	ðaanį́į
consumption (tuberculosis)	mą́ąke ní, mą́ąke púze
contact: bring components into ~(e.g., parts of a blanket)	ðiiskíke
container	oožú, óožu
contaminate (e.g., water on air)	ízizike káaɣe
contempt: hold someone in ~	hpíiži ažį́
contemptible	iiséwaðe
contend with one another	áhkihkie
content (happy)	škaškáða
contest (verb)	áhkihkie
continally	háachi, ną, nąną šǫ, štą
continuative aspect markers	akxa, apa, ąðé, ąðįhé, ąðįkšé, ąhé, ąkáðe, ąkatxą́, ątxą́, ątxąhé, ðaįšé, ðatxą́še, įkšé, kše, mįkšé, nąkxáše, nįkšé, paašé, pai, txą, žą́kše
continue	šką́
continue, continue to	šiną, šǫ
continuously	štą
contrarily	óðąži
contrary: go or be ~ to	áðihta
converse, converse with	ohkíe
converse with each other	ohkíhkie
convince	ožížie
cook (noun, verb)	oohǫ́
cook, cook outside (refers only to cooking meat on a rack, as for barbecue)	óhkace
cook for oneself	óohkihą
cook things, cook stuff	óohǫ
cook together	oðóhkihą
cooked	cúuce
cookhouse	oohǫ́hci
cookie	waskúežį
cooking: add in ~	oðóhkihą
cooking pot	óohǫ
cooking utensils	wéoohǫ, wióohǫ
cookstove	mą́zewéoohǫ
cool (as weather), cool to the touch	níni
coon (raccoon)	mį́hkaa
copperhead	aį́paxo
copulate	wachú
copulate with	aðį́ažą, chúe
cord	wéðį
cork, fishing cork	wíoðaaspe
corn	hápa
corn: cracked ~	hápa waléke
corn: cut ~ (fresh corn cut off the cob)	paašpú
corn: dried ~	óohǫ saakí, watxázu
corn: fresh ~	hápa, hápa wacˀéka
corn: fresh ~ cut off the cob	paašpú
corn: grated fresh ~ baked in oven	wacúe žéela
corn: ripe ~ (just at the point of ripeness)	hápa wasúta
corn: squaw ~ (white term)	hápa wacˀéka
corn husk	wacúexą
cornbread	hápa wacúe, wacúe žéela, wacúeštǫ
corner	paaɣó
cornmeal dumplings	wacúe kaaskí
cornshuck	wacúexą
correct, correctly	ékǫ
correctly: say something ~	ékǫ ðaacé
cosmetics	kikˀǫ́
costume	wéhkilį
cot: small ~	ážąžį
cottonwood	páakˀa, žą́ą kˀa
couch	álįįscee, ážą, óžą
cough (N and V)	hóxpe
cough: have or be suffering from a ~	hóxpe ǫ́ǫ
could	ðąąché
council	ohkíhpa che
council house	hkiistóhci, kiistohcí
council meeting	hkiistó
council member	hkiistó omąðį
council session: tribal ~	hkiistó
count (verb)	ðaawá, waðáawa
count on	íkinaaži
count oneself	hkiláawa
count out	ðaawá
counting	waðáawa
country (land)	mą́žą
country (nation?)	níhkašika ochí
country (rural area)	zą́ą, zą́ące
countryside	mážą, mąžą́htą, zą́ą, zą́ące
couple, pair, two of them	nahkǫį́
courageous	wašóše
court (woo)	ðílą
courthouse	hkiistóhci
courtship: be in a ~ with	žóle
cousin: male ~ (specifically, father's sister's son)	
" my/your/his/her father's sister's son"	hcióška
"my father's sister's son"	wihcóška
"his/her father's sister's son"	ihcóška
cousin: female ~(specifically, father's sister's daughter)	
"my father's sister's daughter"	wihcížo
"your father's sister's daughter"	ðihcížo
"his father's sister's daughter"	ihcížo
cover: pull or tug something over in order to ~	áðuzu
cover (for a tipi, sweat lodge, pillow, etc.)	oðíši
cover oneself up	áhkihkaaspe
cover over, cover up	ákaaspe
cover over by spreading some material upon	ákaaɣace
cover with earth	áðikˀo
covered with: be ~(as a garment)	į́
covering (e.g., a windowshade)	akáaspe
covering wrapped around something	ápetxa
covert, covertly	nąlǫ́ǫha
cow	hcéeska, hceeská mį́įka
coyote	šǫ́mįhkase
crack (intransitive)	kaaléke
crack from sudden impact	kaaxúɣe
crackers.	wacúe xúɣa
cradle of any type, cradleboard.	oðópše
crafts: small ~.	hįįcéžį
cranky.	ókˀą hpíiži, waðílą áška
cranky: feel ~.	hkížį
crash (verb).	kaapxóhke
crave.	kǫ́ða
crawl on, crawl upon.	ámįce
crazed with medicine.	mą́hkažóika
crazy.	cˀéka
crazy, crazily.	ekǫ́įke
crazy person.	waðílą eekǫ́ įké
cream.	paazénii wéli
cream (for applying to a surface to make it smooth).	stáðe
creek.	káxa
creek: small ~.	káxa žį
Creek Indians.	muskóke
crescent moon.	mį́įǫpa aðikeže
crestfallen.	kízoži
cricket.	htáhtaze
crier.	íekie, wacípxaį
Crippled Hawk (personal name).	žekáxǫ letǫ́
crockery.	hį́įce
crone.	wakˀóžį
crooked.	cˀįša, paacˀį́
crooked (referring to a human body).	cˀį́xa
crop: wheat ~.	wapóške ówe
cross (adjective).	ókˀą hpíiži
cross (noun).	cˀáaži
cross (verb).	áðuuhta ðée
crow (noun).	hkáɣe
crowd: help to make a bit of a ~.	wéhuužį
crowd: make a ~.	wéhuu, wéhuukǫį
crowd someone	ohkáðįke
crucifix.	cˀáaží
crumbly: bread that is ~ (i.e., crackers).	wacúe xúɣa
crutch.	íisa
cry (intransitive).	ɣaaké
cry for.	áɣaake
cub (of any species of bear).	wasápežį
cucumber.	hkohkóma
culmination of.	ó-
cunning.	nąlǫ́ǫha
cup.	hcéheska, hcéhežį, mąhkásaioožú,oožú
curb motion.	oðíitą
curl (as a person/s hair).	ðuuhkíhkį
curly.	hkíhkįnį
currency (paper).	htaną́kˀa mą́zeska
curry the mane or coat of an animal.	káapše, kípše, wákaapše
curse (noun).	íe hpíiži
curse (verb).	lǫ́ǫ
curse over and over.	lǫ́ǫlǫǫ
curse someone	hkiláažoži, kilǫ́že
curses.	íe okaaɣéįke
curve (noun).	koša
curved.	cˀįša
curved stick used to play kasini (shinny).	ohkíce
cushion to sit on (as for a sofa, chair, or other seat).	wákaštǫ
custom.	ókˀą
customarily.	ną
cut (adjective).	žáhta
cut (nounoun).	wápaase
cut (verb).	kaasé, paasé, -se, wápaase
cut: one who ~s things up.	wapáse
cut (e.g., with an axe, lawnmower, or knife).	kaasé
cut (e.g., with scissors).	ðuusé
cut a hole in by pushing.	opákˀo
cut into pieces (e.g., a cake).	paasé
cut meat (e.g., slice meat for barbecue).	wakái
cut off.	paasé
cut something for someone	kíse
cut something with something else by pushing down on the item being cut.	ípaase
cut the grass.	mąąhį́ paasé
cut up (e.g., meat, potatoes).	paasé
cut up into slices (e.g., bananas, sausage, watermelon).	pascé
cut with.	íkaase
cut with a sharp edge.	páse
cutthroat.	hpápaxǫ
cutting, cut (nounoun).	wápaase
cutting: by ~.	pá-
cyclone.	htaacé óhesaži
daily.	hą́ąpa záani
damage one's reputation or standing by doing something inappropriate.	ílaną
damaging.	wéhpiiži
damp.	toohká
dance (nounoun, verb).	waachí
dance: he duska ~ (name of a Ponca dance).	hé ðúška
dance: mourning ~.	wašápe aðį
dance: night ~.	hpáze waachí
dance: soldier ~.	áhkitaną́ąžį waachí
dance: solo ~ by one who has been in a war.	wašóše achí nąąžį
dance arbor.	áhcihtą
dance for.	áwaachi
dance place or location.	ówaachi
dances: ~ (war dances or ceremonial dances of the Osages).	ilǫ́ǫška
dancing songs: sing ~, singers of dancing songs.	xóhka
dare not: I ~.	ą́žǫ ðįké
dark.	hą́įnį
dark: become or get ~.	hą́ąnahpazé
dark (in color).	šápe
dark night.	hą́ąnahpazé
darken.	hą́ąnahpazé
darkened.	šápe
darkness.	hą́įnį
darkness of night.	hą́ąnahpazé
date (be in a courtship with).	žóle
dative prefix.	ki-
daughter: babe ~.	asíhpa
daughter: first (eldest) ~.	míina, wakˀóhpa, wakˀóhtą
daughter: fourth ~ (or subsequent daughter).	asížį
daughter: second ~.	wihé
daughter: third ~.	asį́ka
daughter (without reference to age)	
my daughter	wižǫ́ke
your daughter	ðižǫ́ke
his/her daughter	ižǫ́ke
daughter-in-law	
my daughter-in-law	wihcíni
your daughter-in-law	ðihcíni
his/her daughter in law	ihcíni
daughter name: second ~ (hcizo clan).	eeną́tǫįpe
dawn.	hǫ́ǫpahu, mį́įhuðe
day.	hą́ąpa
day: a ~ or two.	hǫ́ǫpa wį́xci ðǫǫpá hta ški
day: last ~.	hą́ąpa oðóhake
day: this ~ some time back, this day back in time.	hǫpái hašíhta
day after tomorrow.	kaasį́ kootáha
day before yesterday.	hą́ąpa kootáha ce, sitǫ́į kootáaha ce
daybreak.	hǫ́ǫpahu, mį́įhuðe
daylight, daylight: be ~.	hǫ́ǫpahu, hǫ́ǫpaskaha
Daylight Approaches, It's Coming Daylight (personal name).	hǫ́ǫpahu
days to come: in ~.	ihtǫ́į ðéha
dead: the ~.	cˀé
dead (e.g. a vegetable).	xéka
dead person.	cˀé
deaf.	nąąɣúcexéka
deal with.	ðuhcépe
dear.	óxta
dear: hold each other ~.	ðótahkiðe
dear: make ~.	óxtakiðe
death.	cˀé, óxiða
death: be near ~.	íhpiiži
debt.	weúuze
decade.	omą́įhka lébrą híeną
deceitful: be ~ toward.	ðiihíce
deceive oneself.	mąɣíhkiðe
deceive someone	ðiihíce, mąɣíðe
December.	mį́įǫpa álįį ðǫǫpá, mį́įǫpa wahkǫ́ta ižį́ke iitáe ékitxą, wasápe iitáipi
decide.	waðílą káaɣe
decide for oneself.	waðílą hkihkáaɣe
deck of cards.	htaną́kˀa ðiihíce, htaną́kˀa kˀǫ
declarative sentence-final marker.	ðe
decomposed.	tožáðe
decrease (transitive).	čóopa ekǫ́ káaɣe
deduce: I ~ that.	ska
deed (act).	ókˀą
deed (document).	htaną́kˀa
deep.	škópe
deer.	htáa
deer: female ~.	htáa mį́įka
deer: male ~.	htáa htą́ka
Deer clan.	htáanihkáši
deer mating moon (October).	htáa hkiðíɣepi
deerskin.	htaaháa
defeat others (in a game or contest).	óhi
defecate.	žé
define as.	ðaacé
deflated.	tóže
defraud someone	mąɣíðe
Delaware (tribe or tribal member).	wápa níhka
deliberate over.	áwaðilą
demented.	cˀéka, pxáðaži
demented person.	pxáðaži, waðílą eekǫ́ įké
denude.	ðuušáake, ðuušáwį, ðuuštá
depart.	aðée, okábra
depend on.	íkinaaži
desire (verb).	kǫ́ða
despair (verb).	hkíxiða
despicable.	iiséwaðe
despise.	íisi
despite: have one's way ~ something	óðąži
despite the odds.	óðąži
despondent.	kízoži
dessert.	waskúe
destructive.	taaðúhpiiži, wéhpiizǐi
detain someone who is passing by.	nąąžį́
detect something (without getting full knowledge of it).	opéni
detergent.	wépukxa
detergent: dish ~.	hį́įce íðuuža wépukxa
determinde.	níhka wažį́htąą, wažį́ ihta
determinedly.	wažį́ ihta
determined person.	níhka wažį́htąą
detest.	íisi
detestible.	iišéwaðe
detour around something	íðišąha
devil.	cˀá htą́ą, ilǫ́ɣe
devoid: be ~ of.	ðįké
devour.	ðaanį́į
dew.	xémąke
Dhegiha.	ðeekíha
diabetes, suffer from diabetes.	žąąníe wapeį́ huukǫ́ða óožu
diamonds (suit in a deck of cards).	pé ðaha
diaper.	híðaxa, xíðaxa
diaphragm.	ðúwe
dice (noun).	kˀǫ́su
dice: play ~.	kˀǫ́sukˀǫ́
dice by cutting over and over.	paasása
dice game.	kˀǫ́sukˀǫ́
die (verb).	cˀé, xíða
die: make ~.	cˀéðe
different.	éeži
different kind: of a ~.	éeži
different one: a ~.	éži wį
different-looking.	éžixci
difficult.	hcéxi, saakí, wahcéxi
Difficult Female (name for a first daughter).	mįįhcéxi
dig, dig up.	kˀé
dig (e.g., a grave).	paakˀó
dime.	waðáawa lébrą
diminish someone by slandering, maligning, or belittling him or her.	hkiláažoži
dine.	wanǫ́bre
dine outdoors.	ášihta wanǫ́bre
dingy.	šóce
dinner (meal served at noon or in the evening).	mįįðóhta wanǫ́bre, ónǫre, wanǫ́bre
dinner bell.	íikaahtamą
dinnerware (e.g., a set of plates, cups, and bowls).	hcéhežį
dipper.	ňíiðaahtą
direction: in a ~.	ha
direction: in that ~.	ée htáha
direction: in the ~ of.	ée htáha, hta, htáha
direction: in the other ~.	ámąhtaha
direction: that ~.	émąhta
dirt.	mą́įhka
dirt: cover with ~.	áðikˀo
dirty (sick, evil).	ízizike
dirty (unclean).	wákalą, wasúhuži
dirty something	ízizike káaɣe
disagree, disagree with.	iiną́hiži
disallow.	ížoši
disband.	okábra, panáa
discard (verb).	ǫ́ǫðe
discard someone or something	ǫ́ǫða
discern something	íikiðe
disconsolate.	kízoži
discouraged: become ~.	hkíxiða
discover in part but not fully.	opéni
discover something	íikiðe
discuss.	íe, óie
disease: venereal ~.	wácinie
disgrace: be in ~.	ílaną
dish.	hcéhežį, hį́įce
dish: flat and wide ~.	hį́įce braaka
dish soap, dish detergent.	hį́įce íðuuža wépukxa
dish towel.	hį́įce ípukxa
dishes (e.g., a set of plates, cups, and bowls).	hcéhežį
disheveled.	héxpa
disinfect (e.g., a buffalo hide).	ðuuwásu
dislike.	íisi
dislike something	kihǫ́ǫži
disliked.	iiséwaðe
disloyal person.	wawį́kšaži
dismissed (as at the end of a school day): be ~.	panáa
dismount from (e.g., a horse).	owísi, wísi
disobey.	opšáži
dispatch (verb).	ðée káaɣe
disperse (transitive, intransitive).	okábra
dispirited.	kízoži
display (multiple items) on top of something else.	ážu
disposition: having a bad ~.	ókˀą hpíiži
disregard.	óðąąceši ðįké
disrespectful.	wakaacˀáiži
dissect.	hpáce
distant: be ~ (e.g., an estranged married couple).	kíðahapa
distant (in space).	wéhice
distant in space or time.	kootáįke
distinct.	ohką́ci
distant: make ~.	wáðaaska
distracted: be ~ by problems or sickness.	ókaše
distraught: be ~ from.	íhpiiži
disturbance.	óochiže
disuse (verb).	óðąąceši ðįké
ditch.	óxe
ditch: small ~ around tipi for drainage.	ną́ceaha
divan.	álį́įscee, ážą žįka
divest oneself of.	níðe
divide (verb).	íhkilai, kíðahapa
divide in two.	ðǫǫpáha káaɣe
divided.	žáhta
divided: be ~.	kíðahapa
divorce.	hkíǫðe, ohkíǫðe
divorce, be divorced.	kíðahapa
divorced: become ~ from.	ohkíǫðe
dizzy.	įcé hpáze
do.	ékiǫ, éǫ, káaɣe
do (engage in an activity).	ǫ́
do for oneself.	hkihkáaɣe
do good works, do good.	ðáalį káaɣe
do harm to.	ðuhpíiži
do how/however, do in whatever way, do what about (indefinite).	háaǫ
do no more.	kaakǫ́ną káaɣe
do nothing.	ókaaɣeįke
do one's best.	íkˀuce, waašką́
do oneself ill or harm.	hkilúhpiiži
do over.	kikáaɣe
do something: make someone ~.	ákaaži
do something poorly.	oolą́ąži
do something to oneself.	éwahkikˀǫ, éwahkiǫ́ðe
do to oneself, do something to excess while paying no heed to others.	éhkiǫ
do what, do what with, do what about.	háaǫ
do whatever with, do whatever.	háaǫ
do work.	waðíhtą
docile.	wacˀéka
doctor (noun), be a doctor.	wahkǫ́taki
doctor someone	šcéðe
document (legal or otherwise).	htaną́kˀa
document containing text.	waléze
document of borrewed money.	mą́zeska ootá waléze
doe.	htáa, htáa mį́įka
dog.	šǫke
dog: black ~.	šǫhtą́ą sa
dog: female ~.	šǫmį́įka
dogwood.	mǫ́ǫsa hu
"doings": have a ~.	ókˀą
dollar.	bróka
dolled up.	íišewai
don (as clothing).	opáahą
done (cooked).	cúuce
donkey.	nąąhtą́htąą
door.	hcižé
doorbell: ring or press the ~.	ðuuhkáamą
doorway.	hcižépe
dotted button-snake-root, dotted gay feather (Liatris punctata).	mąhká saakí
dotted with small dots.	léže
doubt (verb).	wažá
doubt oneself.	hkíxiða
down, downward.	húuce, mą́le
down: go ~ (as a road).	opxą́
down: go ~ (e.g., the sun when setting).	papó
down: put or set ~.	hkícheðe
down: take ~.	ðuuhúuce, ðuxpáwį
downcast.	kízoži
drag.	ðiiɣo, ðiitą́
draw water (e.g., in a bathtub).	ðixtą́, ðuuzé
dream (noun, verb), have a dream.	hǫ́bre
dream: bad ~.	ohpáza
dress (noun).	haaská, wéhkilį
dress in.	íwehkilį, óhkioolą́
dress in. (e.g., a shirt or a dress).	óhkioolą́
dress in clothing (not one's own).	wéhkilį opáahą
dress in one's own clothes.	wéhkilį okíhpaahą
dress oneself.	óhkioolą́
dress up in one's best attire.	íišcewai
dressed up.	íišcewai
dried.	xéka
dried corn.	óohǫ saakí
dried fruit.	hką́ące púze
dried meat.	htáa púze
dried squash.	watxą́ púze
dried up.	hcúɣe
drill: conduct a ~.	áhkita okˀą
drink (verb).	ðaahtą́
drink: soft ~.	niikáapxohke
drink alcohol.	waðáahtą
drink soup.	ðaazúpe
drink up.	ðaanį́į
drive (intransitive).	wakáaži
drive (a vehicle).	kaaží
drive (animals)	mąðį́ káaɣe
drive around for pleasure .	opáwįɣe
drive for someone	kíži
driver.	waðíhtą, wakáaži, wakáaži
drizzle (noun).	íhkišoce, níišoce, niižú xóce, níižu xohtą
droopy.	cˀóka. xpéka
drop (e.g., an object or a comment into a conversation).	ðikšį́ce
drop feathers.	púkaške, wapíokaške, wapúške
drop something into (e.g., eyedrops into eyes).	oðíkˀe
drub.	ochį́
druggist.	mąhká aðį́
drum.	céɣenii
drum: pass the ~.	céɣenii ðée káaɣe
drum tie the ~ (involves wrapping the drum up and tying it).	céɣenii káaɣe
drum boss.	céɣenii ochį́
drumbeat	hcíce
drumkeeper	éeɣenii aðį́
drumkeeper and committee	ilǫ́ǫška záani
drumstick	céɣenii ochį́, céɣenii ochį́ scée, žą́ąxe céɣenii
drunk	llǫ́ðį, omą́įžį
drunk: extremely or "crazy" ~	wéehlihpíiži
drunk: get ~	álǫðį
drunkenness: push or impel someone to ~	páalǫðį
dry (intransitive)	ðipúze
dry (transitive)	púze, púzeðe
dry by wiping	púkxa
dry from heat	táapuze
dry grass, dried grass	xáhtape
dry with (by wiping)	ípukxa
duck	míɣa
duck: big ~	míɣa htą́ka
duck: mallard ~	hpáhiihto
due to	i-
dull (color or finish)	xóce, xpéka
dull (not sharp)	hpaahį́ži
dump out (e.g., garbage)	okáxta
dumplings	wacúe sóso, wacúe táahpa, wacúexǫ oðiši
dumplings: corn meal ~	wacúe kaaskí
dumplings: wheat flour or corn flour ~	wacúe ðubráaska
dun colored (like the color of elk hide)	ópxą hį́į ekǫ́
dung	įlé
during that time	śǫǫšǫ́we
during the night	hą́ą
dust (e.g., the house)	ðicíze
dust off	púɣa
dust off by wiping	púkxa
dusty (as of a table top)	mąąšóce
duty	ówǫ
dwell (in a place)	olį́į
dwell in the forest	žą́a olį́į
dwelling on the cliffs	hpasú olį́į
Dwells among the Cedars (personal name)	xǫ́ǫce mą́į
dying from hunger: be ~	nǫhpéhicˀe
each	kiðá, nąðé
each: belong to ~, one for each one	ihtá na
each other (see reciprocal prefix)	
eager: be ~ that something take place	íhice
eagle	xúða
eagle: bald ~	hą́ka
eagle: golden ~	hcížo
eagle headdress	xúðalą́ke
Eagle Woman (personal name)	xúðáchewį, xúðawį
ear, inner ear	nąąɣúce
ear, outer ear	nąąhtą́
ear pop	nąąɣúce oðipxokši
ear wax	nąąɣúhaśe
earlier	haašíhta (sell also discussion under ska [MODAL])
earlobe	nąąhtą́
early in the morning	kaasį́exci
early morning	hą́ąekǫ́ži, kaasį́exci, kaasį́excįžį
earn	okšéhtą
earnings	okšéhtą
earring(s)	į́įhtǫ
earth	mą́žą
earth, Earth (name for a second son)	mą́įhka
earth: cover with ~	áðikˀo
earthquake	mąžą́ šką́
easily angered	waðílą áška
east	mį́į íðǫpe įkšé
east wind, "fall winds"	pázą htá hu
easy	ómąhka
easy to do	wacˀéka
eat (intransitive)	wanǫ́bre
eat (transitive)	ðaaché
eat: not ~, not be eating	wanǫ́braži
eat too much	tóoceha
eat up	ðaanį́į
eat with	íðaache
eavesdrop	nąlǫ́ǫha waną́kˀǫ
economical	ómąhka
edge	bráaɣe, hkǫ́ha
edging (e.g., fabric sewn round the edge of a blanket)	bráaɣe
educated: be ~	waléze hpíǫ
education	walézeáace
efface by rubbing or wiping	púkxa
effort: make an ~	íkˀuce, waašką́
egg	hpáata
egg someone on	ožížie
egg yolk	hpáatazi
egg white	hpáatazka
eggshell	hpáata xúha
eight	hkietóopa
eighteen, eighteenth	lébrą álįį hkietóopa
eighty, eightieth	lébrą hkietóopa
either	ímąðe
elbow	iistó
elder (noun)	waanǫ́ǫ
elderly man	cˀáižį
elderly woman	wakˀóžį
elders in times past	haašíhta, kóocim nǫ́ǫ
eldest	htą́ą
eldest son	ilǫ́ǫhpa
elephant	níita
eleven, eleventh	lébrą álįį wį́xce
elf	míalǫška
elk	ópxą
else	éški
else: anything ~	táatą éžiški
elucidate	wáðaaska
embarrassed: be or become ~	iizíke
embarrassing: be ~	iizíke
embrace	áace, oðį́įke
embrace as tradition	oðį́įke
emerge from (as a liquid)	stówe
emit, be emitted	žé
employ	waší
employ folks	wawáší
employee	waší
employment, place of employment	waðíhtą
encircle a place or a person (especially in an annoying way)	ákiɣe
encounter (verb)	áhkihpa, áhkiǫðe, áhkoopše
encourage	híce, ožížie
end (intransitive)	panáa
end (noun)	kaašǫ́
end (transitive)	kaaštą́, panáa
end: living on the ~	hpasú olį́į
end: make someone ~ something make something ~	ðiištą́ káaɣe
end: put an ~ to something ~	kaaštą́
end: that's the ~ (interjection)	kaaštą́
end: (it's) the ~	kaašǫ́įke
end: the ~ of earthly living (exclamation)	kaašǫ́eðe
end (e.g., of one's earthly existence)	kaašǫ́
end an activity involving the mouth	ðaaštą́
end of an activity	kaakǫ́ną
ended	kaašéną
endorse (as a check)	mą́šą oðį́įke, šáake oðį́įke
enemies: looking for ~	totą́
enemy	ohkíhce
energetic	sísi
engage in	káaɣe
English (language)	įįštáxį íe
English person	įįštáxį
enjoy	kiðálį, kízo
enjoy: make someone ~	wazóeðe, wazóekšiðe
enjoyment: feel ~	kiðálį, kízo
enlarge	htą́ą
enormous	lą́ąðe wálį
enough	eená, kaakǫ́ną, kaašǫ́
enough: get or have ~ of	íibrą
enough: have more than ~	íibrąxcį
enough: it's ~	kaašǫ́ka
enough: make ~	kaašǫ́ káaɣe
enrage someone	wažį́ hpíiži káaɣe
enraged	wažį́ hpíiži
enter, enter formally (e.g., a peyote meeting)	ohpé
entire	bróka
entrails	otáhpa, šúpe
envious (e.g., of another's position)	óxįį
envy	óxįį
epistemic marker (see evidential marker)	
equal: make ~ to	íkǫskahkíðe
equal in appearance to	íkǫska
equipment: piece of ~	wéhkikˀǫ
erase by rubbing or wiping	púkxa
errand	ówǫ, wamą́ðį
errand: go on a ~	okášą
error: commit an ~ (e.g., dropping something at a dance, causing a commotion)	ílaną
espionage: conduct ~	nąlǫ́ǫha átǫpe
estranged: be ~	kíðahapa
even	ški
even (level)	stáko
even only	ną́ški
even so	óðąži
even though	ški
evening	mį́įhiðe
evening, in the evening time	hpáze
evening: last or yesterday ~	hpázece
evening meal	hpáze wanǫ́bre
event: have or hold an ~	ókˀą
every day	hą́ąpa ke záani, hą́ąpa ohkíeche, hą́ąpa záani
every one	záani
every time	háachi, ohkíetzątxą
everybody, everyone	howaðéeški, huukǫ́ða, péeški, záani
everything	howachéeški, táatą howachéeški,táatą záani
everything else	táatą éžiški
everywhere	háaški
evidential marker	che
evil (adjective)	hǫ́ǫži, hpíiži
evil, evil things	ízizike, táatą hǫ́ǫžį
exactly	xci
examine	ákazo, ákǫze
examine an issue	wákazo
excel, be excellent	álįįha
excessive	ochí, ochíchacha
exchange (noun)	ínkihkawį
exchange one item for another	íhkihkawį káaɣe
excited: be ~	hóšechie [LF]
excrement	įlé
excrete	žé
excursion, go on an excursion	oṕawįɣe
exhausted (tired)	kaaskíke
exhibition	ówatoį
exhibition hall	ówatǫįhci
exist	ecí, ecíke (scattered), níhkašika
exist: not ~	ðįké
exist as	ðį́
exist in large quantity	ochí
exoskeleton	háa šooḱa
expel gas from the body	xpi
experience pain	níe
expert: be ~ in	hpíǫ
explode (e.g	, a balloon) kaapxóhke
extinct: be ~	ðįḱe
extinguish	ðuutáaži
extinguish: become ~	táaži
extremely	wálį
eye (noun)	įįštá
eyebrows	įįštáhįį
eyeglasses	mą́ze įįštólą
eyelid	įįštáhaa
eyes: light ~	(see discusion under įįštáxį)
exult	wakˀą́
fable (Osage children's story in which animals are the main characters)	híko
fabric	háa, haaská
face (noun)	įcé~
face a certain direction	okále
faces: make ~	įcé ðuuhpíiži
faded	xóce, xpéka
fail	ðikšį́ce
fail at doing s.t	oolą́ąži
failing to show respect to people or property	wakaacˀáiži
Fairfax group of Osages	hapsú olį́į
fairy	míalǫška
fall, fall down	xíða
fall (autumn), in the fall	htąątá
fall from a height	oxpáðe
fall into	ohkíǫðe
fall short	oolą́ąži
falling snow	pá húðe
false gossip: malicious ~	íe okaaɣéįke
falsehood (noun)	íxope
family	hcíle
famished: be ~	nǫhpéhicˀe
fan (noun), fanning	kíhką
fan (verb)	kahką́
fan: electric ~	htaacéxowe
fan made of feathers	mą́šą
fan made of tail feathers	íhkuáci
fan off s.o	kahką́
fan off, as at a peyote meeting	kíhką
far, far way, from afar	wéhice
far: how ~	háatxą
far back in time: from ~	kóoci
farewell (to a dead person)	kaašǫ́eðe
farm (noun)	mą́žą
farm (verb)	waðíhtą
fart (noun)	xpi
fart (verb)	ðiipíɣą, xpi
fart: make a loud ~, fart loudly	ðibrį́ɣa
fart (with a small noise, by letting the air out slowly)	ðižíce
farther, farther away, to/from farther, farther back in time or space, farther forward	kootáha
farther one: the ~, in space or time	kóota
farther over there	kootá
fast (adjective, adverb)	óhesaži
fast: go ~	xį́na
fast: walk or move ~	htą́ąðį
fast (not eat)	wanǫ́braži
fast in movement	kˀą́saaki
fasten	aðímą, oðíiną
faster: make s.t	go ~ xįna káaɣe
fat	hį́še, lą́ąðe, šį́, šį́htąką
fat: be ~	wašį́~
fat: pork ~	hkohkósa wéli, wéli
fat meat	wašį́
father	
my father	įhtáci
your father	ðiðáce
his/her father	iðáce
father-in-law	
my father-in-law	wihcíko
your father-in-law	ðihcíko
his/her father-in-law	ihcíko
wife's father/ my wife's father	cˀáke
featherless	iðace įké-
fatigued	óžeðe
favor: ask a ~	waší
fawn (deer)	htáa
fear (verb)	nǫ́ǫhpe
fear: instill ~ in	ðusáaki
fearfull: feel ~	onį́žį
Fearful One (personal name)	nǫ́ǫhpewaðe (specifically, variant from nǫ́ǫhpewali)
fearful thing	nǫ́ǫhpewaðe
fearless	nǫ́ǫhpaži, wašóše
feast (noun)	kíkxo
feast: put on or prepare a ~	kíkxo, óohkihą
feather: turkey ~	súhkahtąą mǫ́šǫ
feathers: drop or brow ~	púkaške, wapúške
February	hǫ́ǫpa scée, mį́įohką́ce, mį́iǫˀaįke, mį́iopa weðǫ́opa
feathers, fan made of-	mą́šą
feathers of certain kinds of birds (such as eagle, hawk, and macaw)	mą́šą
feces	įlé
feed (verb)	́kˀu, wakˀú
feel ashamed	iišcéwai
feel cranky	hkížį
feel fearful	onį́žį
feel good	kiðálį
feel good about	íhtąą
feel good or well	ðáalį
feel oneself to be a certain way	áhkiži
feel someone or something	ðiihtą́
feel sorry for	áacexcį, ðakˀéðe
feel sorry for one's own or someone close	ðakˀékiðe
feel sorry for oneself	ðakðéhkiðe
feeling: get a - about something (without full knowledge of it)	opéni
feign	kǫzé [JOÐ, LFÐ]
female	mį́i, mį́ika
female (used in personal names for females)	wį
female dog	šǫmį́ika
females: without - (said of a family with all daughters and no sons)	mį́ikáðįke
fence	ápahta
fence: wire or metal -	mą́ze ápahta
fetch	akú
fetid odor: have a -	ɣoį́
fever: sick from or running a little -, feverish	áachi
few, a few	čóopa
few: a (e.g., people)	huužį
fib (noun)	íxope
fiddle with something	ðiihíce
field	owe
field: wheat	wapóške ówe
fierce, fiercely	óhesaži
fifteen, fifteenth	lébrą álįį sáhtą
fifth	wesáhtą
fifty, fiftieth	lébrą sáhtą
fight (noun)	taaké
fight (verb), fight against or with	taaké
fight (verbal)	taaké ie
fighting	taaké
fill: have one's - of	íibrą
filled: be - (sated)	wéenące
filled: be -	okúhpu
film (noun)	ówatoį
final	oðóhake
final: be -	ecí che
final event in life: the - (exclamation)	kaašǫ́eðe
final part of something	kaakǫ́ną
final point	kaašð̨
find (verb)	íiðe, íikiðe
find bothersome	áalake
find for oneself; find one's own	iihkíðe
find out (transitive) (e.g., about someone's activities)	ðuupxáðe
find out about (without getting full knowledge of)	opéni
find out things	wáopxa
fine (noun)	ílanąwakísupe
fine (e.g., fine rain)	xohtą
fine (of high quality)	ðáalį
finely	ðáalį
finger	pázo, šáake
finger: index -	opázo, wéapazo
finish, be finished	ðiištą́
finish eating	ðaaštą́
finished, the thing is finished	kaašéną
fire (e.g., a cooking fire, meeting fire, or cooking-stove fire)	hpéece
fire: build a -	océðe
fire: build a - on	áceðe
fire: set - on	osái
fire a gun	hkúce
fire-drill stick	hį́iceceˀohu
fire-making wood (a piece of wood used in making fire)	žą́ąhpeece
fireman (a position in Native American Church meetings)	hpéece íhta
fireplace: build a	océðe
fireplace (in a home or ceremonial)	océhci
fireplace or fire (of any kind, to cook or to warm oneself)	océðe
Fire-walker (personal name and family name)	hpéece mąðį́
firewater (whiskey or any strong alcoholic drink)	hpéecenii
firewood	hpéece žą́a
firm	saakí
first	hpahą́le
first: place something or someone ~	hpahą́le mąˀį́
first son in hcížo clan	wahcéehtą
First Striker (personal name)	hpahą́le ákaaleke
fish	hó
fishhook	íhkǫe
fishing	hóolą
fishing cork	wíoðaaspe
fishing line	hóize
fishing pole	hóize žą́axe
fist	nǫǫpé, nǫǫpé aski
fist: make a ~	ðiiskíke, šáakeðíiskike
fit (verb)	íhta
fitting in the available space: not -	wíohkaðį
five	sáhtą
five cents	waðáawa sáhtą
five-spot (in a deck of cards)	sáhtą aži [LFÐ]
fix (e.g., repair a torn place in a dress)	kikáaɣe
fix (prepare)	káaɣe
fix (prepare or repair) for someone	kšíɣe
fix (remedy)	ðuðáalį
fix one's own, fix up something of one's own	lúðaalį
flag	haawálele
flag, U.S. flag	waléle
flashlight	ðuuhpéece
flask for gun powder	níixoce weoožu
flat	bráaska, brákˀa, brúuska
flat, flattened (said of a soft object)	tóže
flatten	ðibrúuska
flatten by cutting	pábrakˀa
flatten by shooting	póbraska
flatten by striking	kaaštá
flatten with the feet	nąąstá
flatulence	xpi
flea	wísisi
flee	hkóopše
fleet (as a runner)	kˀą́saaki
flint	kaalį́įže
flirt with	ðílą
flirt with a woman	wakˀóðílą
flooded (e.g., a creek)	okúhpu
flooding water	níita
floor	ánąąhkoe
flour	wacúexo, wacúe
flow (verb)	stówe
flower	laaská
flower on a tree	žą́ąlaa
fluid	níi
flute	opíɣą
fly (noun)	hą́hceka
fly (as birds do or in an airplane)	kį́į
fly out in pieces: cause to - or splinter	paasíke
foam up	ápuɣe
fog	íhkišoce
fog rising off standing water	opˀą́ða
follow	íe opšé, opšé
following (adverb)	áhkiha
following (pronoun, adjective), the following one	okxą́
following: go	oðáhaaðee
Follows-the-Sun (an Eagle clan name)	mį́íšechie
food	ónǫbre
food: sweet ~	waskúe
food bag	wánǫbréoožú
food taken from home from a feast	óðaašce
fool someone	ðiihíce, mąɣíðe
fool someone	wáðihota
foolish acts	cˀéka ókˀą
foot	síi
foot: by ~	nąą-
footprint	šáake
for	(see dated prefix)
for a day or so	hǫ́ǫpa wį́xci ðǫ́ǫ́ hta ški
forbid	ížoši
force (noun)	waašką́
force over or through something	ákaaži
force someone to do something	kaaží
forceful, forcefully	óhesaži
forebearers, forefathers	mǫ́pše, nǫ́ǫwaapi
foregoing: the ~	ée
forehead	hpée
forehead: smooth ~	hpéeštá
foreknowledge: have ~ of an event	ónąkˀǫ
foreman	oðówaðe, waðíhtą wakáaži
forenoon, in the forenoon	mįįðóhta žišǫ́
forest	są́ą, žą́ą
forest: dwell in the ~	žą́ą olį́į
forever	šǫǫšǫ́we
forget	áalǫðį, kisúðaži
fork	wahúhka
forked	žáhta
forked: make -	pážahta
forked lightning	ðiléleze
forty, fortieth	lébrą tóopa
forward: go -	aðée
forward (rude)	wakaacˀáiži
four	tóopa
Four Cliffs (personal name)	hpásitoopa
fourteen, fourteenth	lébrą álįį tóopa
fourth	wétoopa
Fox (personal name)	šǫ́mįhkase
fracture (e.g., one's head)	kaaléke
fragment	ošpéžį
fragrance: give off a -	brą́
frail: be ~	waašką́ðįké
frankfurter, Indian frankfurter	tǫ́ǫpše
free: be: ~ at last from illness	ónihkie
free from worry or illness	ókašeįke
free will: of his/her own -	wašį́ ihta
freeze	táa
freeze: make something ~	ótaa
freeze in or to another substance	ótaa
freeze one's own	táahkiðe
freeze to, freeze sticking to something	átaa
French (adjective)	íšpaðǫ
French language	íšpaðǫ
French person	įįštáxį, íšpaðǫ
frequently	íkiha
fresh	hcéka
Friday	hą́ąpa htaaðáachaži
fried	taazíhi
friend	hcošpá, hkóða, ihkówa
friend: make a ~ of	iiðótahkiðe
friend: person who is made into a ~	iiðótahkiðe
friend: regard as a ~	ðótaðe
friends: make ~ with each other, regard each other as ~	ðótahkiðe
Friend's Church (Quaker) in Hominy	wíkihcižį
frog	hcéokˀa
from	ci txą, ha, hta, í-, íhta, txą́ha
from now on	ðetxą́ce, ðetxą́ha, ihtǫ́į ðéha
from the beginning	hpahą́ke
from this time on	ðetxą́ha
frost	xémąke
frowzy	héxpa
frozen: be ~	táa
fruit	hką́ące, waskúe
fruit juice	hką́ącenii
frustrated: be or become ~ 	níǫhta
fry	taazíhiðe
frybread	wacúe wéli
frybread: deep-fried ~	wacúe žéela
frybread that is slit through	wacúe kaascú
fulfillment as a person	ónihkaši
full: be ~	okúhpu
full: be ~ (sated)	wéenące
full: make oneself ~	wéenącehkiðe
full amount	okúhpu
full moon	mį́įǫpa táahpa
full sie	htą́ą
fully	xci
fun: be ~	waaó
fun: have ~	kízo
fun: make ~ of someone	wahóta
funny	wahóhota, wahóta
funny: be ~	íixaéewaðe
funny-looking	éžixci
funny person	wahóhota
funny stuff	cˀéka ókˀą
fur	hį́į
furnish	okˀú
furnish to folks	ókˀu
furnishings, furniture	ohcíle
further over	kootáha
future (noun)	hą́ąpa ihtóį ðeha, kóota ðée
future: in the ~	hą́ąpa ihtóį ðeha, ihtóį ðeha, ihtǫ́į ðihé, kóota ðée
future tense marker (see potential marker)	
fuzz (as on a peach)	hį́į
fuzzy	héxpa, hį́įšce
fuzzy balls (e.g. on yarn garters ), fuzz (as on a sweater)	hį́įšcežį́
gadabout	wáaspaži
gadget	wéhkikˀǫ
gain (N and V)	okšehtą
gale	htaacé óhesaži, htaacé saakí
gallant	wašóše
gamble	kˀǫ́
game bird	míɣa
gap	ohtą́ną
garage	oðíhtąhci, wakáaži
garage door	oðíhrąhci hcíže
garden	ówe
garden produce	ówe, wasúutą
garlic	mą́ąžąxe
garment	mį́
garter	híǫnįį
gas: pass ~ or air	ðiipíɣą
gasoline	wéli
gather (transitive)	ðiiskíke
gather (e.g. fruit)	ðuuzé, paahí
gather and tie in a bundle	paaxcé
gather for council	kiistó
gather together, gather with	waðíiski
gather up	ðiiskíke
gather up for oneself, gather together for oneself	hkilíiski
gather up with a sudden movement	kaaskí
gather with each other, gather together	hkilíiski
gathering of people (e.g., at a dance), people gathering with each other	hkilíiski, waðíiski
gaunt	lažį́į
gay person	miixóke
gayfeather (Liatris punctata)	mąhká saakí
gelatin	waskúe ðibrúbruɣe, waskúe šką́šką́
generation: older ~	mǫ́pše
generation after generation, generational (referring to a long line of chiefs)	ótxątxą
generous	waðákɣeðe, wahríše
Generous (non-Osage surname)	wahríše
gentle	štáke, wacˀéka, waštáke
Gentle Man (personal name)	níhka watą́įke
get	akú, ðuuzé
get (i.e., 'become'; e.g., get old	ahí
get a feeling about something (without full knowledge of it)	opéni
get back here	alí
get back (in regard to illness)	kiní, kitą́he, kítąhe
get drunk	álǫðį
get here	achí
get it anyway	óðąži
get lost	oxpáðe
get moving, get going	mąðį́
get moving! (command)	mąðį́ ðíe
get off (e.g., a horse)	ósi, wísi
get one's own	lúuze
get oneself into something by oneself	éwahkiǫ́ðe
get oneself ready	hkílištą
get oneself tangled in	ohkíǫðe
get out of (e.g., a car)	ósi, wísi
get ready	háhahkie
get rid of	ǫ́ǫðe
get stuck to	káataace
get the idea: not quite ~	hahkíe
get there (as in a room or a place)	oną́ąžį
get undressed	hkílíiša, hkilúušawa, hkilúuštake
get up (from a bed or a chair)	hpaahą́
get up (preparatory or departing)	nąąžį́
get well	kiniˀ, kitąhe, ónihkie
get word of	opéni
get-together	ohkíe
ghost	ilǫ́ɣe, waną́ąɣe
giddy	cˀélǫðį
gift card	íe ðáalį žį
girl, girlfriend	šį́mįžį
give	kˀú, okˀú
give a name for something or someone	ðaacé
give away	níðe, wakˀú
give away (e.g., the drum at ilǫ́ǫška dances)	kaaðée
give away to each other	ohkíkˀu
give back	kíkˀu
give birth	iitáðe, wéetaðe
give birth to	iitáðe
give each other	hkikˀú
give out in portions (e.g., food)	íhkilai
give stuff to someone	ókˀu
give testimony	wawépahǫ
give things away	waníðe
give to one's own, give away to one's own people	kíkˀu
give up	hkíxiða
giveaway	nąnįǫ́kužu [archaic], ókˀu, waníðe
giveaway: have or hold a ~	ohkíkˀu, waníðe
glad	kízo, óweena
glad: be ~	kíðálį, wéeną
glad: be ~ of	wéeną
glass (noun)	íkǫpa
glass: pane of ~, window glass	okáhąpa
glasses (eyeglasses or any device worn over the eyes)	mą́ze įįštóolą
glutton	tóoceha
go	mąðį́
go: let ~	ðée káaɣe
go: make or cause to ~	ðéeðe
go ahead	mąðį́
go ahead with something	ékiǫ
go around	ákiɣe, ápše, kǫ́kǫe
go around something	íðišąha
go away	mąðį́, okábra
go back and forth	ihkílašą
go behind someone's back	nąlǫ́ǫha
go by (i.e., stop in)	ahí
go by (go past)	ípše
go by foot, by walking	mąðį́
go by using	iiðée
go down (as a road)	opxą́
go down (e.g., the sun when setting)	papó
go fast	xį́na
go faster: make something ~	xį́na káaɣe
go following	oðáhaaðee
go for a ride	opáwįɣe
go for a walk	mąðį́ aðée
go forward	aðée
go home, go back	mąlį́
go home, go back there (motion underway)	alée
go hunting (for)	htáabre aðée, océ
go in, go into	ohpé
go looking	tǫ́pe aðée
go on	mąðį́
go on! (command)	mąðį́ ðíe
go on (continue)	šką́
go on a mission or journey	wamą́ðį
go on an excursion	opáwįɣe
go on horseback	hkáwaalįį aðée
go out (become extinguished)	táaži
go out (in a card game)	íiðį
go or be up above	ámąši
go past	ípše
go shopping	waðúwį aðée
go table-hopping	ákiɣe
go there (motion accomplished)	ahí
go there: make something ~	ðée káaɣe
go there (motion underway)	aðée
go through (as a road)	opxą́
go to bed	žą́ą
go to war	taaké, taaké omą́ðį
go toward you, go to the place where you are or near you	šoðée
go walking	mąðį́ aðée
go where you are: make ~	šoðée káaɣe
go with	oðáhaaðee
goal	ohkíce
goat	į́hįhkicéže
God	hpahą́le mąðį́ ąðiðaace, wahkǫ́ta
going: get ~	mąðį́
gold (in color), golden, goldlike	mą́zeska zí ékǫ
gold (metal)	mą́zeska zí
golden eagle	hcížo
golf	htaapéskažįkˀǫ́
golf: play ~	htaapéskažįkˀǫ́
golly	éeše [slang]
golly! (female exclamation of surprise)	wį́kše
gone (finished)	kaašéną
gone: be ~ (absent, nonexistent)	ðįké
good	ðáalį
good: be ~ to	ðakˀéðe
good: be ~ to each other	ðakˀéhkiðe
good: feel ~	kiðálį
good: make oneself ~ (e.g., in respect to one's behavior)	ðáalįhkiðe
good behavior	óðohtą, óðohtąhkiðe
good grades in school: have or make ~	alįįha
good health: be in ~	ní
good health: in ~	ókašéįke
good manners, thoughts or ways: having ~	ókˀą ðaalį
good time: have a ~	kízo
good time: show someone a ~	wazóekšiðe
good to one's own or to someone close: be ~	ðakˀékiðe
Good Voice (personal name)	hooðáalį
good works or good: do ~	ðáalį káaɣe
good-bye	kaašǫ́įke
good-bye (to a dead person)	kaašǫ́eðe
good-looking	ðáalį, ohtáza
goodness!	ą́žǫ ðįké
goof, goof up	ílaną
goose	míɣa, míɣa htą́ka
gorget	wanǫ́pˀį
gosh! (female exclamation of surprise)	wį́kše
gossip	tíðe
gossip: malicious and false ~	íe okaaɣéįke
gourd, gourd rattle	hpéɣe
government	mą́ąhį htą́ą
grab hold of	kaaskí
grab someone	ðiiskí
grace (as said at mealtime)	waatá
grain: any kind of ~ (such as wheat, oats)	wacúe
grain sieve	wacúe ikaaži
grand	htą́ka, lą́ąðe
grandchild	
my grandchild	wihćospa, wihćoska, hcošpá
your grandchild	ðihcóšpa, ðihcóška
his/her grandchild	ihcóšpa, ihcóška
grandfather	
my grandfather	wihćiko, hcíko
your grandfather	ðihcíko
his/her grandfather	ihcíko
grandmother	
my/his/her grandmother	iihkó
your grandmother	ðiihkó
grandmother lightning	iihkó lǫ́ǫ
grandmother thunder	iihkó lǫ́ǫ
grandparents	ðiihkówa
grape	háazu
grape juice	háazunii
grasp	ðiihtą́, oðį́įke
grasp someone by the scruff of the neck	ðiiskí
grass	mąąhį́
grass: cut the ~	mąąhį́ kaasé
grass: dry or dried ~	xáhtape
grass: sweet-smelling ~	hpéže brąðáalį
grasshopper	htáhtaze, įįštáxį htáhtaze
grateful	óweena
grateful: be ~ (for)	wéeną
grave	óxe
graveyard	óxe mą́žą
gravy	htáa lįkó, lįkó
gray	šóce, xóce
grayish (like ashes)	xóce
grayhorse	hkáwa xóe
Grayhorse camp (near Fairfax, Okloahoma)	hkáwaxoce
Grayhorse group of Osages	hpasú olį́į
grease	stáðe, wéli
grease: meat ~	htáaweli
greasy	ðóðo
great	htą́ka, lą́ąðe
great deal: a (a lot)	wálį
great-grandchild	wihcóšpa áhkiha
my great-grandchild	ihcóšpa áhkiha
his/her great-grandchild	ihcóšpa áhkiha
greed	íibrąži
greedy	íibrąži, tóekǫ́ži
green (color)	htóho [LFÐ], mąąhį́ htóho
green (unripe)	cúutaži
green beans	hǫbrį́ke, hǫbrįke htóho žį
green onions	mąąžą́xe htóho
green tea	hpéže htóho
greens (vegetable)	ówe, wasúutą
greeting card	íe ðáalį žį
grief, grieve	kihǫ́ǫži
grill (refers only to cooking meat on a rack, as for barbecue)	óhkace
grimace (verb)	įcé ðuuhpíiži
grin (noun), with a grin	íixažį
grind, grind up	ðilǫ́že
grind together (e.g., the teeth)	ðiiskíke
grinder	hówe
grinningly	íixažį
groceries	ónǫbre, ówe
grocery store	ówe hci
ground (earth)	mą́įhka
ground (earth): bare ~	oštá
group including individuals just mentioned	éeðǫǫpa
grow in size	htą́ą
grow up	nǫ́ǫ ahí, nǫ́ǫ ðiištą́
grow up to adulthood	nǫ́ǫ
growl	xowi
grownups	nǫ́ǫ
guess	ípahǫ
guess: I ~ that	ska
guess what?	táatą íbilą che
guinea hen	súhka léze
gullet	tóoce
gum	mį́įhtǫeli
gun	wahóohtą
gunpowder: flask for ~	níixoce weoožu
habitually	ną [ITERATIVE]
haggard	lažį́į
hair	hį́į
hair: roached ~	hé káaɣe
hair (of the head or neck of a human or an animal)	hpaxį́į
hairbrush	wékaapše
haircut	hpáxį ðuusé
haircut: roach ~	hpaxáce
hairdo: women's bun ~	hpáxį ðuutáahpa
half	ohkisce
half a container	hépe
half dollar	ohkísce
half moon	mį́įǫpa aðikeže [LFÐ]
halfway point, at the halfway point	ohką́ska
halt	kaaštą́
halt someone who is passing by	nąąžį́
halt something (e.g., the horse pulling a buggy, the motion of a car)	oðíitą
halve	ðǫǫpáha káaɣe
hammer (noun)	wékaaspe
hammer (verb)	kaaštá
hand: pass by ~	kˀú huu
hand: (also used in referring to the body that are touched by the attendees when passing by a body at a funeral)	šáake
hand game	šáakeoolą́kˀǫ́
hand over, hand to	húðe
hand towel	šáake ípukxa
handbag	mą́zeskaoožú, wáseska
handcuff	paaxcé
handgun	wahóohtą
handkerchief	haaléžowaake, haaská wanǫ́pˀį
handle	ðuhcépe, okášą
handle meat with the hand	htaaðíihtą
handle something with the hand	ðíihtą
handprint	šáake
handshake: have a ~	šáake oðį́́įke
handsome	ðáalį, ohtaza
hang around	ákiɣe
hang up (e.g., clothing)	opáhce
hanging on the back of or behind something else: be ~	oðáha
happen	ékǫ, híeną
happen upon	áhkiǫðe
happy	škaškáða, wakˀá
happy: be ~ about something	kiðálį, kízo
hard (difficult)	wahcéxi
hard (in texture)	saakí
hard (with force)	óhesaži
hard to do things with	saakí
hardly	to
hare	mąšcį́ka
harelip	íhaa žáhta
harm (verb)	ðuhpíiži
harm: do or cause oneself ~	hkilúhpiiži
harm oneself by making a serious mistake	hkilúhpiiži
harm someone physically, mentally, or emotionally	ðiižóži
harmful	wéhpiiži
harmful behavior: engaging in ~	taaðúhpiiži
harmony: in ~, harmoniously	škaškáða
harness	hkáwa hkihkáaɣe
harvest	wapóške ówe
hat	óoląke
hat: don as a ~	óoląke
hat: Osage wedding ~ (a top hat with plumes optionally worn by the bride)	lǫǫhúu
hatch	paaléke, páleke
hatchet	mą́ąhįspežį
hate	íisi
hate a person	hpíiži ažį́
hateful	iiséwaðe
have	aðį́
have: not ~	ðįké
have as one's own	ahkílį, aláðį
have for oneself	ahkílį
have nothing	ðįké
have one's way despite something	óðąži
have someone do something for his/her own benefit	kšiðe
hawk	héka, letǫ́, súhka oðį́įke, wažį́htąą
hawk: black ~	letǫ́sape
hawk: redtailed ~	letą́ ǫ́pe žúuce
Hawk Woman (personal name)	letǫ́wį
hay	mąąhį́
haywire from medicine	mą́hkažóika
haze	níišoce
Heizo (an important Osage tribal division)	heížo
he too	éekitą
head	hpá, hpée, wéeli
head: bald ~	hpeeštá
head: item worn on the ~	óoląke
head: under the ~	į́pehi
head: wear or put on the ~	oolą́ke
head: with the ~ covered	oolą́ke
head committeeman	totą́ha wahtą́ka
head cover	óoląke
head of cattle	hcéeska
headdress	htaasį́įce
headdress: eagle ~	xúðalą́ke
headright	hcíwažu
heal	kiní, kiní káaɣe
heal fully	kítąhe
healed: be ~	ónihkie
healer	wahkǫ́taki
health problems: have ~	íhpiiži, íhuheka
healthy	sísi
hear, hear about	nąkˀǫ́
hear a rumor	ónąkˀǫ
hear of one's own	kínąkˀǫ
heard: something ~	ónąkˀǫ
hearing: (act of hearing)	nąąɣúce
hearing (legal proceeding)	áhkiisto
hearsay	ónąkˀǫ
hearsay: known by ~	áape
heart	ðą́ące
heart attack	ðą́ące ðuusáaki
heart: broken ~	ðą́ące ðuusáaki, ðą́ące xǫ́
heart: have a pain in the ~	ðą́ąceníe
heartache	ðą́ąceníe
hearts (suit in a deck of cards)	ðą́ące, nį́cekˀa
heat (transitive)	táahkace káaɣe
heater: hot water ~	mą́ze níi táahkace káaɣe
heating: smell (good or bad) from ~	táabrą
heaven	mą́žą ðáalį, wahkǫ́ta mą́žą
heavy, heavily laden	skíke
heed (verb)	ánąkˀǫ, opšé
heifer	hcéeska, hceeská mį́įka
hellcat	ilð̨eži iiséwai
hello	hawé
help	óhką
help one's own	okíhką
help someone (who is not a relative)	okíhką
help someone with a task	óhka
help: hired ~	wašížį
hen	súhka mį́įka
hen: guinea ~	súhka léze
hen: turkey ~	súhkahtąą mį́įka
henceforth	ðetxą́ha
her, hers (possessive)	íhta
herd (noun)	opáhce
herd (verb)	kaaží, mąðį́ káaɣe
here near you	šée
here, be here	ðeeká
here (in this place)	káa
hernia	heéze bráze
hiccup	tóoske
hickory nut	hpáhtąą
hidden item	nąlǫ́ǫhkile
hide (verb)	nąlǫ́ǫha, púuspe
hide (animal skin)	háa, xúhaa
hide (animal skin): remove the ~ from anything	ámaxa
hiding place	nąlǫ́ǫhkile
high: hold ~	ðumáða
high noon	mįįðóhta
high quality: of ~	ðáalį
high-tempered	ókˀą hpíiži
highway	óžąke
hill	paaɣó, paaxó
hip	ǫ́pe
hip joint	ší ǫ́pe
hire	waší
hire folks to work	wawáší
hire people to work for oneself	áwawaší
hired hand, hired person	waší
hired help	wašížį
his, be his, belong to him	íhta
hit (e.g., a drum)	kaaštá
hit (e.g., a drum or a person)	ochį́
hit (e.g., someone on the side of the head)	kaabráze
hit hard, hit with a stunning blow	káasaaki
hit someone in a way that shakes him/her up badly	kaaníeži
hit someone in the head	taašéðe
hit someone on the back, knocking the wind out	kaapxóhke
hit things (such as a drum)	óchį
hit with	iichį
Hochunk (Winnebago) (tribe or tribal member)	hóhtąka
hoe	mą́įhka íðištǫka
hog	hkóhkosa
hoggish	hkohkósa ékǫ
hold: have or take ~of	oðį́įke
hold: take ~ of one another	mą́hki
hold an opinion of something	ažį́
hold down (e.g., a lid or a person)	śpisą
hold each other dear	ðótahkiðe
hold high	ðumáða
hold military maneuvers	áhkita okˀą
hold oneself in a certain way	áhkílaðį
hold onto, hold	oðį́įke
hold sacred	ðixópe, óxta káaɣe
hold up	ðuumą́ši, opáahą, paahą́
hold up (to display)	paamą́ši
hold up someone or something	ðiihą́
holder (container)	oožú
Holding, Frances Oberly (personal name: Hawk Woman)	letǫ́wį
hole	kˀó, okˀó
hole: make a ~	okákˀǫ
hole: punch or a cut a ~ in	opákˀo
Holes in the Wings (personal name)	áahukˀoe
holler	hóohtą, pá
holler for folks	wapą́
holy	xópe
holy: regard as ~	óxta káaɣe
home	hcíle, ohcíle
home: bring or take ~ (motion accomplished)	aðį́akši
home: go ~	mąlį́
home: make a ~	hcíle
home: my ~ (similar to chez moi in French)	ecí mįkšé
home: return or go ~ (motion underway)	alée
home: take ~ (motion underway)	aðį́alee
home: take ~ for oneself or as one's own	ahkílįalée
homely (not pretty or handsome)	ohtázaži
hominy	watáažoe
Hominy	hą́ąmąðį
Hominy district	ząącéolįį
homosexual	miixóke
honest	wáðohtą
honey	hkilǫ́ɣemąį
honor (verb)	áxope, ðixópe, kíoxta
honored	óxta
hook	íhkǫe
hook and line	hóize, íhkǫe
hook of any kind	húhka
hook something (e.g., clothing or a tree by using a thrown line)	húhka
hopeless: feel ~	hkíxiða
horn (of animal)	hé
horn (wind instrument)	opíɣą
horned toad	kalǫ́eže
horse	hkáwa
horse: wild or untamed	hkáwa wahcéxi
Horse Feeder (personal name)	hkáwa óˀku
[may be an error for	hkáwa óˀku]
Horse Giver (personal name)	hkáwa wakˀú
horse herder, horse watcher	hkáwatǫpa
horse whip	wékaaži
horseback	hkáwaalįį
horseback: go on ~	hkáwaalįį aðée
horserace	hkáwa hkipáną
hosiery	hįįǫke
hospital	húhekahci
hot (said of objects or substances; not usually used of persons)	táahkace
hot water heater	mą́ze nii táahkace káaɣe
hour	mįį́oðaake ohtánq
house	hcí, hcile
house: long ~ covered with brush or canvas	wažáihci
house of God	wahkǫ́tahci
housefly	hą́hceka
houseful	okúhpu
household	hcile, ohcile
housekeeping: set up ~, set up a household	hcile
how	haakǫ́, hǫ́ǫche
how about	hą́a
how big	háaðaską
how far	háatxą
how long	háatxą
how many	háaną
how much	háakǫ́, háaną
how small	háaðaską
however	oðąži
howl	hóohtą
hug	oð́įįke
huge	lą́ąðe wálį
human	nihkaśie
human: be ~	inihkaśie
human body	žúoka
humble	waxpáðį
humorous	wahóhota, wahóta
hunchback	cˀóxe
hundred, hundredth	lébrą huuźį
hungry	nǫhpéhi
hunt for	océ
hunting	htáabre
hunting: go ~ (for)	htáaðre aðée
hunting: squirrel ~	sįkóce
hunting expedition: go on a ~	kaalǫ́ðe
hunting time	hceetóoka kiśipi
hurriedly	xįna
hurry (verb)	hice
hurry: cause to ~	híceðe
hurry: in a ~	hwahkǫ́i
hurry: make someone ~	wáhice
hurry along	htą́ąðį
hurry someone	híceðe
hurry someone along	ihíce, wáhice
hurry something up	xį́na káaɣe
hurry up!	ónalį
hurrying toward something	ostówe
hurt	níe
hurt one another physically or emotionally	hkilíižoźi
hurt someone physically, mentally, or emotionally	ðiižoži
husband	
my husband	winíhka, níhka wíhta
if the couple's first child is a boy	wižį́ke iðáce 
when the husband is elderly	cˀáižį
your husband	ðiníhka, níhka ðíhta
her husband	iiníhka, níhka íhta
my/your/her husband	ilǫ́ǫhpa iðáce
husband: take as a ~	áðuɣe
husk (noun): corn ~	wacúexą
husk (verb)(e.g., corn)	ðuušáake
I	wíe (emphatic)
I too	wíškítą
Iba: Priscilla ~ (personal name)	wažážemį́įhcexį
ice	ną́ɣe
ice cream	ną́ɣe kípše, ną́ɣe paazénii
ice tea	hpéženii ną́ɣe oolą́
ice water	ną́ɣenii
icebox	ną́ɣeoožú
idea	waðilą, wažį́
identical to	kǫzékǫ idle ókaaɣeįke
if	tą (often not overtly expressed in Osage)
ignorant: be ~ (about something, of something)	kíopxaži
ill: be gravely ~	íhpiiži
ill: be ~ with	íhuheka
ill: do oneself	hkilúhpiiži
ill fortune: having ~	waxpáðį
ill-advised	ékǫži
illegitimate, illegitimate child	íðace įké
ill-mannered	ókˀą hpíiži
illness	húheka
illness: be free at last from ~	ónihkie
illness: be suffering a period of ~	ókaše
illness: have as an ~	ǫ́ǫ
illness: suffer from an ~	kihúheka
ill-tempered	ókˀą hpíiži
imitate	íkǫskahkiðe
immaterial	ókaaɣeįke [LFÐ]
immature	nǫ́ǫhiži
immediately	wąkǫ́ǫžį
immediately when: and ~	áha, iáha
impatient: be ~	íhice
impeded: be ~ by problems or sickness	ókaše
impel someone to drunkness	páalǫðį
imperative markers	a, ði, pai
imperfectly: do (something) ~	oolą́ąži
implement (tool)	wéhkikˀǫ
important	lą́ąðe, óxta
important: make ~	óxtaðe
important: make oneself ~	óxtahkiðe
impossible, impossibly	ðąącháži
improbable	ékǫžie ska
improbably	ðąącházi
improve with regard to an illness	kitą́he
in	ci , ki
in: be ~ an area or a group of people	omą́ðį
in: go ~	ohpé
in: live ~	olįį
in: put ~	oožú
in: put stuff ~	óožu
in (something lying or spread out)	kši
in (something sitting or round)	įkši
in a direction	ha
in addition	ški
in an offhand manner	íðilą ðįké
in attendance: be ~	ahi
in between	ohtą́ną
in bulk	bróka
in charge: be ~	oðóðe
in charge: be ~ of	oðówaðe
in front of and blocking	oðóši
in harmony	škaškáða
in order to, so that. (usually not overtly expressed in Osage, but only implied)	
in place of (see dative prefix)	
in spite of	óðąži
in that time	ée htáha
in the direction of	ée htáha, hta, htáha
in this manner	kaakǫ́
in this place	káa
inadequate: be ~	oolą́ąži
inappropriate	éeži, ékǫži
inappropriate, inappropriate action	ókˀą ekǫ́ži
inappropriately	ekǫ́įke, íhtaháaži
inceptive prefix	ki-
incessantly	štą
incinerated: be ~	táaðįke káaɣe
incite	ožížie
incorrect: be ~	ðikšįce
incorrectly	ekǫ́įke
increase in size	htą́ą
increase something a bit	wéhuužį
indeed	wálį
indeed (adverb)	xci, -žį
index finger	opázo
Indian, Indians	níhka žúuce
"Indian butter" (i.e. meat grease)	htáaweli
individual	níhkašie, ohką́ci
indoors	hcíhta
industrious	wahtóke
inebriated	lǫ́ðį, omą́įžį
inebriated: very badly ~	wéehlihpíiži
inefficient	hǫ́ǫži
inevitably	óðąži
inexpensive	ómąhka
infamous	iiséwaðe
infant, infancy	hpáažį
inferior	hǫ́ǫži
inferior: be ~	oolą́ąžį
inflict upon oneself	éhkiǫ
inform	óðaake
inhabit	olį́į
inherit	aláðį
injunctive markers	hce, htai
inner ear	nąąɣúce
innocent	ilánąðįké
inoculation: administer an ~	mąhká oðíkˀe
inquire after one's own people or things	ilǫ́ɣe
inquire into	ákazo
insane	cˀéka
insect	páðo, walúška
inside, in (as in 'come in/inside [the house]')	hcíhta
inside: place ~ of	oolą́
inside out	háašįðe
inside out: make ~	ðuháašįðe
insides (entrails)	šúpe
insolent	wakaacˀáiži
inspect	ákazo
instill fear in	ðusáaki
instruct	(see discussion under hce ée)
instrument: musical ~	paakíce
instrument: wind ~	opíɣą
instrumental prefixes [instr]	ðaa-, ðu-, kaa-, nąą-, pá-, paa-, pi-, pó-, pu-, táa-
insufficient	eeną́ži
insufficient (said of clothing)	cúuða
insult by word	ðaažóži
intelligent, intelligence	waðíląhtąą
intend	wakšé
intense: more ~	óhesaži
intercourse: have ~	wachú
intercourse: have ~ with	aðį́ažą, chúe
interest money	mą́zeska oðótą, oððtą mą́zeska
intermingle	oðóhkiðe
interpret for another	íe waská íkikaaɣe
interpreter	íe waská
interrogate	íðǫɣe
interrupt	ohkíkˀǫhe
interview, interview a person	ohkí́e
intestines	šúpe
into	hta, ki
into: fall or jump ~	ohkíǫðe
into: get ~	ohkíǫðe
into: get oneself ~ something by oneself	éwahkiǫ́ðe
into: go ~	ohpé
into: put ~	okˀǫ́he, oolą́
intoxicated	lǫ́ði, wéehlihpíiži
invert	ðiisą́ða
invert one's own	liisą́ða
investigate	ðuupxáðe, waðúupxai
invite folks	wapą́
invite folks to appear before others	wáapą
invite one's relative(s)	kíhpą
invite others to feast	kíhxo
invite someone (not a relatives)	kípą
inward	mąchéhtaha
Iowa or Ioway Indians	páxoce
irascible	ókˀą hpíiži, waðílą áška
iron (verb)	ðuuštáha, puštáha, wapúštaha
iron (verb), iron something	waðúuštaha
iron (metal)	mą́ze
Iron Hawk (personal name)	letą́mąze
Iron Necklace (personal name)	mą́ze wanǫ́pˀį
irrelevant	ée htáhaži
irritable	waðílą áška
irritated: be ~ by	áalake
island	niǫhta žįka
isn't it so?	hį́
isolate	ohką́ci káaɣe
isolated	ohką́ci
isolated from	ákahahta
it is time	éetxą, mįįðóhta
it is time again	ékitxą
itch: scratch an ~	kˀúe
item	tą́ąska
iterative markers	ną, nąpe
jack (in a deck of cards)	žáhke
jack mule	nąąhtą́htąą
jail, jailhouse	hą́ąnahpazéhci
jail: put someone in ~	hą́ąnahpazé oolą́
January	hą́ąpascee, mį́įohką́ce, mį́įǫpa hpąhą́le, omą́įhka heéka, wasápe íikitali
jar	oožú
jaw	ðéepa
jealous (e.g., of another's position)	óxįį
jealous (used of a man), man who is jealous	míwatą
jealous: be ~ about(used of a woman), woman who is jealous	ną́wązi
jealousy	óxįį
Jell-O	waskúe ðibrúbruɣe, waskúe šką́šką́
jerk hair out	ðuuštáštai
Jesus Christ	wahkóta ižį́ke
job	waðíhtą
john (toilet)	ožéhci
joke: make a ~ of something	ixaéewaðe
joke: play a ~ on	ðíhota
joyous	wakˀą́
judge (verb)	wákazo
judgment: use bad ~	ílaną
juice: fruit ~	hką́ącenii
July	mį́įǫpa hpeðǫ́ǫpa
jump (intransitive)	owísi, wísi
jump, as when startled	hóšechie
jump over	áwisi
jumping game	wísikˀǫ
June	hceeróoka kišipi, hceetóoka mąąną́ɣape, mį́įǫpa wešáhpe
just	na, ną́ški
just now, just a while ago	hcéka
just right, just the right amount	káaną
Kansas gayfeather (Liatris punctata)	mąhká saakí
Kaw, Kansa (tribe or tribal member)	hką́ąze
keep (as a souvenir, memento, or treasure)	kícheðe
keep on (doing something)	šíną, štą
keep on (with the action of the verb)	nąną
keep true to someone's word	íe opšé
keepsake(s)	wahcéka
Kemonah: Carl ~ (personal name: White Mountain)	paaxóska
kerosene	wéli
kettle	céɣe
kettle: small	céɣežį
kettle: soup ~	htaaníe céɣe
key	wéðušupe
kick (transitive)	nąąstá
Kickapoo Indians	kihkápo
kidney (human or animal)	sinǫ́bre
kid(s)	žįká, žįkážį
kids: take care of ~	žįkókašą
kill	cˀéðe
kill oneself	cˀéhkiðe
kill others, kill folks	wacˀéðe
kind	waðákˀeðe
kind: be~	íðakˀéðe
kind: be~ to each other	ðakˀéhkiðe
kind: be~ to one's own or to someone close	ðakˀékiðe
kind of (somewhat)	ékǫ
kind: what ~	hǫ́ǫxcį, táatą
kindling: fine ~	žąąhcúkˀa
kindness: show or use ~	íðakˀéðe
king (in a deck of cards)	wahtą́ą
kinky	hkihkįnį
Kiowa (tribe or tribal member)	hpá tóohka, hpáðį
kiss	ííšįka
kiss one's own	ííkišcįka
kitchen	oohǫ́hci
knead meat with the hand	htaaðíihtą
knead something with the hand	ðíihtą́
knee	šį́įce
knee joint	žeká óhkiche
kneecap	šiðǫ́ce
knife	mą́ąhį
knock someone in the head	taašéðe
knock someone out	kaalǫ́ðį, kaaníeži, káasaaki
knot: tie a ~	ákaške
know (e.g., a fact, the answer to a question)	ípahǫ
know as a person, know someone as	ípahǫ
know for oneself	hkihpíǫ
know how: not ~ (to)	kǫ́žįka
know how to do something	hpíǫ
labor: be in, labor (during childbirth)	waníe
lack, be lacking	ðįké
lack strength	waašką́ðįké
lacking: be ~	níðe
ladle	hcú hápa,níiðaahtą
lame	wahkúcˀa
lamp	átahką
land	mą́žą
language	íe
languid	xpe
lap (part of the body)	wéetaha
lard	hkohkósa wéli, wéli
large	htą́ą, htą́ka, lą́ąðe
large: exceedingly ~	lą́ąðe wálį
large: very ~	lą́ąðehtą
large amount	huuhtą́ka
large number of	huuhtą́ka, huuwáli
large quantities: in ~	bróka
last (adjective)	haásí, haašíhta, oðóhake, paðíhta
last: the one before ~	kootáha
last (the most recent)	ce
last day	hą́ąpa oðóhake
last evening	hpázece
last night	hą́ące
last summer	tookéce
late	wascúuce
late: always ~	ókxąži
late afternoon	mį́įhpapo
laugh, laugh at	íixa
laugh: cause folks to ~	íixaéewaðe
laughable: be ~	íixaéewaðe
laughing stock	iixaéewaðe
launder	ðiiškí
laundry: do ~	waðíiškí
laundry: do ~ for oneself	hkilíiškí
laundry (clothes to wash)	waðíiškí
laundry (place), laundry house	waðíiškíhci
law	ówaðaace, wahkílaace
law enforcement	áhkita
lawmaker	hkiistó omąðį, wahkílaace káaɣe
lawn	oštá
laws: make ~ (as in Congress)	wahkílaace káaɣe
lawyer	wáhke
lay (have sex with)	aðį́ažą, chúe
lay into	kˀǫ́he
laziness	oðúucˀake
lazy	oðúucˀake
lazy: be ~	óðuucˀake
lead (in a card game)	ðée káaɣe
lead (metal)	mą́ze
lead a life	ónihkašika
leaf	žąąpé
lean	bréhka
lean (used to describe a person or animal)	lažį́į
lean up against	áakxą, áðiikxą
learn	hpíǫ, waðíląhtąą, wahpíǫ
learn for oneself	hkihpíǫ
learn how to do something	wahpíǫ
learned: be~	waléze hpíǫ
learning	walézeáace
lease money	wą́zeska oðitą, oðótą mą́zeska, ootá mą́zeska
leasing of land	mą́žą óota
leastways	našǫ
leave (as leftovers)	ošcé
leave (depart)	aðée
leave (e.g., a crowd leaving after a dance or other public gatherings)	okábra
leave (someone)	kíhkoopše
leave alone	šǫ́įkšeðe
leave alone (a sitting person or thing), leave it alone	šǫ́įkšeðe
leave alone! (command)	šo ðíe
leave alone without bothering, touching, or otherwise disturbing	šǫ́cheðé
leave be! (command)	šo ðíe
leave behind	áalððį, ǫ́ǫðe
leave it alone	kaaśǫ́e che
leave it/him/her (lying down) alone! (command)	šǫ́kśeðe
leave someone	ǫ́ǫða
leave someone barely alive	toníðe
leaves	žą́ąpe
leaves or leaflike layers: having ~	xáxa
left, lefthand	ðáhta
left over be ~	ošcé
leftover	ðaacˀáke, ošcé che
leftover amount	ošcé
leftovers (scattered around)	ošcé ke
leftward	ðáhta
leg	žeká
leg (e.g., of spider)	hú
legal proceeding	áhkiisto
legend	óðaake
leggings	hį́įǫke
legislate	wahkílaace káaɣe
legislator	hkiistó omąðį
lemon	hką́ące zi cˀáaðe
lend	okˀú
leprechaun	míalǫška
lesbian	míixóke
less than full amount	ohépe
lessen	čóopa ekǫ́ káaɣe
let, let's (see injunctive markers)	
let go	ðée káaɣe
let it alone, let it be, let it sit	kaašǫ́e che
let someone be	šǫ́įkšeðe
let someone do something	kšíðe
let slip (as a comment), let slip away	ðikšį́ce
letter	óðaake waléze, wáleze
lettuce	hpéžehtoho
level (adjective)	stáko
liar	íxopeštą́
Liatris punctata (grayfeather, blazing star)	mąhká saakí
lice	hée
lick (verb)	ðaaštápe
lick (n, v)	íxope
lie abed	óžą
lie down	ážą, óžą
lie down against	áðiikxą
lie down, as to sleep or rest	áakxą
lie down in	óžą
lie down to sleep	žą́ą
lie to	mąɣíðe
lie up against	áakxą
life	oníhkašie
life: lead or live a ~	ónihkašika
life: live this~	mą́žą ðé ómąðį
lift (verb)	ðuhcépe, ðumáða, ðuumą́ši, paamą́ši
lift off	ðuxpáwi
lift someone or something	ðiihą́
light (noun)	átahką
light in color	ɣį
light weight	háha [LFÐ]
lighten	ðuuhepe
lighter (noun)	ðuuhepéece
lightning	lǫ́ǫ waléze, níǫpapa
lightning: forked ~	ðiléleze
lightning: grandmother ~	iihkó lǫ́ǫ
lightning strike(s)	kaalį́
likable	ókˀą ðaalį
like (verb)	kiðálį, kíhǫǫ, kízo
like: act ~	íkǫskahkíðe, ókˀą
like (similar to)	kǫzékǫ
like each other (resembling each other)	kǫzéhkihkǫ
like that or this	ékǫ
limb of a tree	káxa
limb of a tree: broken ~	žą́ąkaaxǫ́
limbs of a tree or bush: small ~	žą́ąžį, žą́ąxežį
line (fishing line)	hóize
lined (having lines)	léze
lion	michó
lip: broken or split ~	íhaa žáhta
liquid	níi
liquid medicine	mąhká oðáahtą eeną́
liquor	hpéecenii
liquor store	hpéeceniihci
listen, listen to	ánąkˀǫ
louse (noun).	hée
love (verb).	ðáęąceíki, kiðálį, kíhǫǫ
love one's own.	kíoxta
loved.	óxta
lower by pulling (e.g., a window shade).	ðuuhúuce
lowland.	oźo
lukewarm	štáke
lulu.	ðaazó, waðáazo
lumbago	wahúni
lumber.	žą́a
lunch.	mįįðóhta wanǫ́bre, oðaašce
lung.	ðǫ́ɣu
lying down (position). (see continuative aspect markets; positional articles)	
macaw	wažį́kaíe
machine or machinery.	wéhkikˀǫ
mad (angry).	lą́, wažį́ hpíiži
mad (angry): be ~.	ohkížį
mad (angry): become or get ~.	óžį hpíiži
mad (angry): feel at someone	hkížį, ohkížį
magazine.	óðaake wáléze
maiden.	kažą́si
mail (verb).	ðéeðe, ðée káaɣe
mail to another person.	ðeekšíðe
make.	káaɣe
make (someone do something or be a certain way).	káaɣe
make (someone do something or be a certain way).	káaɣe, kaaži
make (up) for oneself (e.g., one's bed).	hkihkáeɣe
make a crowd.	wéhuu, wéhuukǫ́į
make a fist.	ðiiskíke, šáakeðíiskike
make a hole.	okákðǫ
make a home.	hcíle
make a joke of something	íixaéewaðe
make a phone call	mą́zeie híðe
make a recording with an audio device	íe ðuuzé
make a talk or speech	íe
make an effort	waašką́, ikˀuce
make bald or bare	ðuuštá, ðuuštáštai
make believe (verb).	kǫzé [JOD, LFD]
make-believe.	ék̨oska ha
make camp.	ahcí, hcí
make change, make a change.	íhkihkawį káaɣe
make curly	ðuuhkíhkį
make dear.	óxtakiðe
make die.	cˀéðe
make equal to.	íkǫskahkíðe
make faces.	įcé ðuuhpíiži
make folks want to, make one want to	kóðawaðe
make for someone	íkikaaɣe
make for someone (e.g., food or a bed)	kšíɣe
make forked.	pážahta
make friends with each other.	ðótahkiðe
make from.	wékaaɣe
make fun of someone	wahóta
make go/	ðéeðe
make go where you are.	šoðée káaɣe
make good.	ðuðáalį
make it (in a card game).	káaɣe
make it anyway.	óðąži
make it slow.	lúžihkiðe
make laws (as in Congress)	wahkí̌laace káaɣe
make lie down or be in bed, have another in bed.	ðížąą
make lighter.	ðuuhépe
make no more (of).	kaakóną káaɣe
make one look or appear a certain ay.	tǫ́pewaðe
make one's best effort.	íkˀuce
make one's mark upon something	páaleze
make oneself (to be or do).	hkíðe
make oneself comfortable	hkikˀáze
make oneself full.	wéenącehkiðe
make oneself important.	óxtahkiðe
make oneself ready, make yourself ready	háhahkie
make oneself right and respectful	óxtahkiðe
make oneself straight.	óðohtąhkiðe
make out of.	íkaaɣe
make over.	kíkaaɣe
make plain or distinct	wáðaaska
make round.	ðuutáahpa
make sick.	húheka káaɣe
make slower.	lúži káaɣe
make someone do something	ákaaži, kaaži
make someone hurry	wáhice
make someone nervous	páalǫðį
make someone put on an article of clothing.	įkšíðe
make someone successful	ðáalį kšíðe
make special.	óxtaðe, óxtakiðe
make something bad.	ðuhpíiži
make something go to another person.	ðeekšíðe
make things plain (e.g., words or lines on a paper, borders on land).	wáðuuska
make trouble ~ for someone	ówǫ káaɣe
make up (apply makeup).	įcé káaɣe
make up one's mind.	waðílą hkihkáaɣe, waðilą káaɣe
make using.	wékaaɣe
makeup.	kikˀǫ́
makeup: apply ~.	įcé káaɣe
male.	tooká
male child.	šį́tožį
males: be without ~ (said of a family with all girls).	tooká ðįké
male singers at a dance.	xóhka
malicious false gossip.	íe okaaɣéįke
malign.	ðaažóži
mallard duck.	hpáhiihto
malodorous.	ɣoį́
man.	níhka, níhkašie
man: eldery ~.	cˀáižį
manacle.	paaxcé
manage.	ðuhcépe
manage (e.g., an event).	oðóðe
mandible.	ðéepa
mane.	hpaxį́į
maneuvers: hold military ~.	áhkita okˀą
mangy.	hcúxe
manner: in this ~.	kaakǫ́
manners: having no ~.	okˀą hpíiži
mantle.	ákahamį, mǫkápo
many.	huuhtą́ka, huuwáli
many: be ~.	ochí, óšechiðe
many people.	huukǫ́ða
many things.	táatą ochí
map.	mąžą́waleze
March.	hą́ąpa ohkísce, mį́į okˀą́ike, mį́įǫpa weðáabrį
marines.	áhkita omą́ðį
mark: make one's ~ upon something	páaleze
maroon (color).	pazó ekǫ́
marriage (term used by friend or family of groom).	mį́įląke
married: be or get ~ (said of a man).	mį́įląke
married: be or get ~ (said of a woman).	wáðuɣe, wéðuɣe
married woman.	wakˀó wéðuɣe
marrow.	wažúpe
marry (transitive).	žóle
marry: make one's own relative ~, marry of a female relative (e.g., one's daughter).	wáðuɣekíðe
marry (a man).	áðuɣe
marry (a woman).	lą́ke
marry a woman.	mį́įląke
marry each other.	hkilą́ke
marvelous.	óxta
Mary (Mother of Jezus).	wahkǫ́ta ižį́ke iihǫ́
mash down.	ápisą
Mashunkashey: Russel Koshehe ~ (personal name: Buffalo Chief).	ðóxe kahíke
match (for lighting a fire)	ðuuhpéece
mate (transitive).	ðúɣe
material.	haaská
mattress.	omíže
mature.	nǫ́ǫ
may, might (see potential marker).	
May.	mį́įǫpa wesáhtą
maybe.	nąka
me.	wíe
me too.	wiškítą
meadowlark.	mǫ́ǫke zí htą́ą
meal.	ónǫbre
meal: evening ~.	hpáze wanǫ́bre
meal: noon or evening ~.	wanǫ́bre
meal: noon or midday ~.	mįįðóhta wanǫ́bre
meal: take care of a ~ oneself when asked to do so.	óohkiką
mean (hateful).	iiséwaðe
mean (have a certain meaning).	ékǫ
mean (intend).	wakšé
meaningless.	ókaaɣeįke
means: by ~ of, a means to.	í-
means to see each other again.	wéehkile
meantime.	ihtǫ́į ðéha
meanwhile.	katxą́
measure (verb).	ðaawá
measuring stick.	žą́ą wéðaawa
meat.	htáa
meat: burred or charred ~.	táasaaki
meat: fat ~.	wašį́
meat candy (pounded meat).	htáa štǫ́ka, htáapše
meat gravy (popular Osage dish made of boiled meat).	táalįko
meat pie.	htóolą (old meaning), htóožu, síekǫ
meatball.	htáa štǫ́ka
medal, medallion.	mą́zeska wanǫ́pˀį, wanǫ́pˀį
medical care: administer ~ to someone	šcéðe
medicine.	mąhká
medicine: liquid ~ (medicine that comes in liquid form only).	mąhká oðáahtą eeną́
medicine: one who has ~.	mąhká aðį́
medicine bundle.	mąžáhku, waxópe
meditate on.	áwaðilą
meet (transitive)	áhkihpa [JOD, LFD], áhkiǫðe, áhkoopše
meet and talk things over.	kiistó
meet each over, meet someone	íihkihkiðe
meeting.	hkilíiski
meeting: hold a Native American Church or peyote ~.	hkihkǫ́ze
meeting: peyote or Native American Church ~.	hkihkǫ́ze, mąhkáðaaché
meeting held by a group of people.	hkiistó
meeting of a group of people to converse.	ohkíe
mellow (adjective).	cúuce, táaske
melt.	táaską
member: be a ~(e.g., of a club).	oðízą
memento: keep as a ~.	kícheðe
men.	níhka, níhkašie
men: young ~.	nǫ́hǫ́žį
menstruate.	waaláke
"mentally retarded," mentally unstable.	cˀéka
merciful: be ~ to.	ðakˀéðe
merely.	ną́ški
Merry Christmas.	wahkǫ́ta ižį́ke hą́ąpa iðáalį
merry-go-round.	kǫ́kǫe
mess (trashy mixture).	táatą ochí
message sent by wire.	mą́zekˀąsaaki
messed up.	ɣǫ́ǫce
metal of any kind.	mą́ze
meteor.	mihkákˀe oxpáðe
Mexican or other native Spanish-speaking person.	íšpaðǫ
midday.	mįįðóhta
midday dinner or meal.	mįįðóhta wanǫ́bre
middle.	ohką́ska
middle: be in the ~.	iðǫ́eðįhé
middle: down the ~.	opxá
middle: in the ~.	ohką́ska
midnight.	hą́ą ohkáska, hą́ą ohtą́ka
might.	(see potential marker)
might (noun).	waašką́
migrate.	kalǫ́ðe, wahúį
mild (a person's ways or the weather).	štáke
military maneuvers: hold ~.	áhkita okˀą
military service: be in ~.	taaké omą́ðį
milk.	paazénii paazénii ðiiscúe
milk: sweet ~.	paazénii skúðe
mill.	hówe
million.	waðáawa htą́ke
mind.	waðílą, wažį́
mind: have a good ~.	waðíląhtąą
mind: have in ~.	wakšé
mind: have on one's ~.	íðilą
mind: have something on one's ~.	táatą íðilą
mind: I don't have the ~.	ą́z̨ǫ ðįké
mind: in one's right ~.	ną́ąɣeska
mind: make up one's ~.	waðílą hkihkáaɣe, waðílą káaɣe
mine (PRON).	wíhta
minister of a religious group.	oźą́ke olį́į, wahkǫ́taki, wakǫ́ze
mink.	hį́zįį
mirror.	niióhkiacˀį
misbehave.	taeðáalįži
mischievous.	iiscéwai
mischievous: be ~.	ðiihíce, taeðáalįži
mischievous (said of a person who tends to laugh and make fun of people).	óškika
misconstrue.	íe ðaaéži
mislead.	oxráðe káaɣe
misrepresent oneself.	mąɣíðe
miss (a target).	kakšį́ce
miss (be lonesome for, long for).	íkišike
miss (not get right).	ðikšį́ce
miss each other.	íhkišike
miss out on (e.g., a dinner by arriving late).	kakšį́ce
miss the mark.	oolą́ąži
mission, go on the mission.	wamą́ðį
Mississippi River.	níi htą́ka
mist.	íhkišoce, níišoce, niižú xóce, niižú xohtą
mistake: make a ~.	hkilúhpiiži
mistake: make a (disgraceful) ~ that brings attention to oneself.	ílianą
mistake (noun) (not a particularly serious mistake).	wanáhkai
mistaken: be ~.	mąðíhkiðe
misting rain.	íhkišoce
mistreat.	ðiižóži
mistreat (an animal or person).	ðiihíce
mistreat one another.	hkilíižoži
mistreat someone	ðišǫ́ži
mistrust oneself.	hkíxiða
mixed blood: person of ~.	įįštáxįžį́
mixed in, mixed among.	íwihe
mixture: thrashy ~ (of items that are out of order).	táatą ochí
moccasins.	hǫǫpé
moist.	mąątóohka, toohká
moment: at this ~.	ðekǫ́ǫce
moment: the ~ for something	éetxą
Monday.	hą́ąpa hpahą́le
money.	mą́zeska
money: paper ~.	htaną́kˀa mą́zeska
money bag.	mą́zeskaoožú
monkey.	héeoce
month, month's time.	mį́įǫpa
month before last.	mį́įǫpa kootáha
moo (verb).	hóohtą
moon (noun).	mį́įǫpa
moon: crescent ~	mį́įǫpa aðikeže
moon: full ~	mį́įǫpa táahpa
moon: half ~	mį́įǫpa aðikeže
more	oðóhake, ši
morning	mį́įhuðe
morning: early ~	hą́ąekǫ́ži, kaasį́exci, kaasį́excicžį
morning: late ~	mįįðóhta žišǫ́
morning star	mihkákˀe hą́ąpa tą ðikše, mihkákˀe hą́ąpaska tą, mihkákˀehtąą
morose	ókˀą hpíiži
mortar (for grinding)	hówe
mosquito	brápxąąke, lápxąąke
most recent: the ~	ce
mother: 'my mother'	iiną́
mother: 'your mother'	ðiihǫ́
mother: 'his/her mother, the/a mother'	iihǫ́
mother of Jesus	wahkǫ́ta ižį́ke iihǫ́
mother-in-law: 'my mother-in-law'(for some speakers, specifically 'my wife's mother')	wakˀǫ́žį (wíhta)
mother-in-law: 'your mother-in-law'(for some speakers, specifically 'your wife's mother')	ðíwakˀožį, wakˀǫ́žį ðíhta
mother-in-law: 'his/her mother-in-law'	íwakˀóžį
mother-in-law: 'my husband's mother'	iihkó
Mother's Day	íihǫhą́ąpa
mound	hpá
mountain	paaɣó, paaxó
mounted on a horse	hkáwaalįį
mourn (transitive)	kíkxą
mourning dance	wašápe aðį́
mouse	įchóka
mouth	íhaa
mouth: big ~	íhcuke
move (intransitive)	šką́
move (transitive)	ðicíze, ðuušką́
move: unable to ~ (as a motor vehicle)	šką́aži
move all around	ákiɣe
move fast	htą́ąðį
move to another location	wahúį
movement: make a back and forth ~ (as when riding a teeter-totter)	sísiąðe
movie	ówatoį
movies	hkéetaxewatǫ́e
moving: get ~	mąðį́
much: be ~	óšechiðe
much: this ~	káaną
mucus: filled with ~	xtoe
mucus from the nose	hpahlíxtoe, hpalį́
mud	mąąstósto, mą́įhka
muddy	mąąstósto
mule	nąąhtáhtą́htąą
murder	cˀéðe
muscle	áahkǫ
muscular	saakí
muse about	waðílą
mushroom	mihkákˀe
music	paakíce
music: play ~ on an instrument	paakíce
muskrat	htachí, įchóhtąą
must: it ~ be that	ska
mutter in complaint	lǫ́ǫ
my	wíhta
my goodness!	ą́žǫ ðįké
my home (similar the chez moi in French)	ecí mįkšé
mysterious power	wahkǫ́ta
naked	hį́ðohkižį
name	žáže
name: assign, give, or use a ~	ðaacé
name: call on someone's ~	ðaacé
name: call someone a bad ~	lǫ́ǫ
name: say the ~ of something or someone	ðaacé
name one's own	láace
name used to make fun of someone	žáže wahóta
names: call ~	lǫ́ǫlǫǫ
names: call each other ~	hkílǫ(lǫ)
names: call folks ~	walǫ́ǫ
napkin	íhaa ípukxa, šáake ípukxa
napkin: paper ~	htaną́kˀa ípukxa
narrate	oðáake
narrative	óðaake
narrow	wahóšce
nation	níhkašika ochí
Native American Church (the religion given this name)	hkihkǫ́ze
Native American Church meeting	mąhkáðaaché
Native American Church meeting: hold or put on a ~	hkihkǫ́ze
Navajo (tribe or tribal member)	haxį́ležekáaɣe
navy	áhkita omą́ðį
near, nearby	áška
near the time of that	ée htáha
nearly	ðóha, hóni
neat	stáko
neaten	ðuustáko
neck	htáhu
neck: wear around the ~	nǫpˀį́
neckerchief	haaléžowaake, haaská wanǫ́pˀį
necklace	wanǫ́pˀį
necklace of iron or other metal	mą́ze wanǫ́pˀį
needle	súhka húhka
negative markers [NEG]	aží, ðįįké, ðįké, maží
negatively be affected by too much of something: be ~	íibrą
Neosho (in Oklahoma)	niióšo
nephew (specifically son of brother of female): 'my brother's son' (speaker is female)	wihcóška, wižį́ke
nephew (specifically son of brother of female): 'your brother's son' (addressee is female)	ðihcóška, ðižį́ke
nephew (specifically son of brother of female): 'her brother's son'	ihcóška
nephew (specifically son of brother of male or son of sister of female [same terms for 'son'])	'my brother's son' (speaker is male) or 'my sister's son' (speaker is female)	wižį́ke
nephew (specifically son of brother of male or son of sister of female [same terms for 'son']): 'your brother's son' (addressee is male)	ðižį́ke
nephew (specifically son of brother of male or son of sister of female [same terms for 'son']): 'his brother's son,' 'her sister's son'	ižį́ke
nephew (specifically, son of sister of male or son of brother of wife): 'my sister's son, my wife's brother's son' (speaker is male)	wihcóška
nephew (specifically, son of sister of male or son of brother of wife): 'your sister's son, your wife's brother's son' (addressee is male)	ðihcóška
nephew (specifically, son of sister of male or son of brother of wife): 'his sister's son, his wife's brother's son'	ihcóška
nerve: I don't have the ~ !	ą́žǫ ðįké
nervous: make someone ~	páalǫðį
nest	hcí
never (no Osage phrase exactly matches the range of use of English 'never')	aži ną
never on time	ókxąži
never will (for future time only: no Osage phrase exactly matches the range of use of English 'never')	aži hta
nevertheless	óðąži
new, newly	hcéka
new things	wahcéka
new year	omą́įhka hcéka
news	óðaake
news: shocking or startling ~	hóšechie
newspaper	htaną́kˀa waléze, óðaake waléze
newsprint	htaną́kˀa waléze
next	áhkiha, ímąche, okxą́
next: and ~	kaðǫ́
next: the one after ~	kootáha
next-to-last	kootáha
nice	ðáalį
nice-looking	stáko
nickel (five cents)	waðáawa sáhtą
nickname (noun)	žáže wahóta
niece (specifically, daughter of brother of female): 'my brother's daughter' (speaker is female)	wihcióžąke
niece (specifically, daughter of brother of female): 'your brother's daughter' (addressee is female)	ðihcióžąke
niece (specifically, daughter of brother of female): 'her brother's daughter'	ihcóžąke
niece (specifically, daughter of sister of male): 'my sister's daughter' (speaker is male)	wihcížo
niece (specifically, daughter of sister of male): 'your sister's daughter' (addressee is male)	ðihcížo
niece (specifically, daughter of sister of male): 'his sister's daughter'	ihcížo
niece (specifically, daughter of brother of male or daughter of sister of female [same term fro 'daughter']): 'my brother's daughter' (speaker is male) or 'my sister's daughter' (speaker is female)	wižǫ́ke
niece (specifically, daughter of brother of male or daughter of sister of female [same term fro 'daughter']): 'your brother's daughter' (addressee is male) or 'your sister's daughter' (addressee is female)	ðižǫ́ke
niece (specifically, daughter of brother of male or daughter of sister of female [same term fro 'daughter']): 'his brother's daughter' or 'her sister's daughter'	ižǫ́ke
night	hą́ą, hpáze
night: at ~	hą́ą
night: darkness or dark of ~	hą́ąnahpazé
night: last ~	hą́ące
night: late ~	hąą káaši
night: stay all ~	žą́ą
night before last	hą́ące kootáha ce
Night Walker (personal name)	hą́ąmąðį
night woman	hą́ą wakˀó
nightmare	ohpáza
nighttime	hą́ą
nine, ninth	lébrą hce wį́įke
nineteen, nineteenth	lébrą álįį hce wį́įke
ninety, ninetieth	lébrą lébrą hce wį́įke
no (interjection)	hą́ąhkaži
no ears (a person who won't listen)	nąąɣúce ðįké
no good	óškika
no more: make ~ (of)	kaakǫ́ną káaɣe
no more: there is ~ (interjection)	kaaštą́
no value: something of ~	mą́ąhpiiži
nobody	pée, hǫ́ǫe wį, péeški
nocturnal	hą́ą
noise	óochiže
noise: not make a ~	oní ðiké
noise: ticking, tapping, or clicking ~ against metal (as made by a typewriter)	mą́ze htáhtaze
noisy: be ~	óochiže
noncontinuative marker (3rd person)	api, i
none: be ~	ðįké
nonexistent: be ~	ðįké
nonsense [LFD]	ókaaɣeįke
noodles	wacúe kˀą́saaki
noon	mįįðóhta
noon meal	mįįðóhta wanǫ́bre
normal eyesight: have ~	wawéeðe
normally [ITERATIVE]	ną
normally	nąpe
north	níwahcekši htáha
north[LFD]	pásąci
north wind	nį́ ké hta huðe
nose	hpá
nose: runny	hpahlíxtoe, hpalį
Nose Cutter (personal name for a second son)	hpápaxǫ
not anything else, not anything but	na
not be present	ðįké
not be thus	ékǫži
not careful	íinǫǫhpaži
not difficult	wacˀéka
not easy to do	wahcéxi
not enough	eeną́ži
not exist	ðj̨ké
not fitting in the available space	wíohkaðį
not get something right	ðikšį́ce
not have anything, lack	ðįké
not have anything to do with s.o or s.t	šǫ́įkšeðe
not in one's right mind	waðílą eekǫ́ iké
not know how (to)	kǫ́žįka
not lazy	wahtóke
not make noise	oní ðįké
not quite dark yet	hpáze
not quite get the idea	hahkíe
not quite right: do (s.t)	oolą́ąži
not right	eekǫ́ ðįké, ékǫži
not satisfied anywhere	eˀélǫðį
not trust oneself	hkíxiða
not understand	kíopxaži, pxáðaži
not up to par: be	oolą́ąži
not where or how it is supposed to be	ekǫ́įke
not wild	wacˀéka
not worried	škaškáða
notch	pážahta
notched	žáhta
note (document of borrowed money)	mą́zeska ootá waléze
nothing: it's	ókaaɣeįke
nothing: say	íeži
nothing like it	táatą ékǫ ðįké
nothing more	kaašǫ́įke
nothing wrong	ókašéįke, škaškáða
notwithstanding	óðąži
November	mį́įǫpa álįį wį́xci, súhkahtą mį́įǫpa
now (adverb)	ðekǫ́ǫce
now (interjection)	ną
now: from - on	ðetxą́ha, ihtǫ́į hta
nude	hį́ðohkižį
nudge	paaspą́
number(s)	waðáawa
nun	šǫmį́hka wakˀó
nurse (N,V)	húheka okášą
oak	hpisúhu
oatmeal	wéšj̨
Oberly: Frances-Holding (personal name: Hawk Woman)	letǫ́wį
Oberly: Myrtle-Jones (personal name)	wažáxį
obey	íe opšé, opšé
obey (e.g., the law)	oðóohpa
obey one's own	okípše
object: sacred	waxópe
object to	iiną́hiži
obliterate by rubbing or wiping	púkxa
observe	tǫ́pe
observe people or events	watǫ́pe
obtain	ošéhtą
occupation	oðíhtą
occupy a seat	olį́į
ocean	níi htą́ka, níimąse
o'clock	mį́įoðaake
October	htáa kiðíɣepi, mį́įǫpa lébrą
odd	éeži
odd-looking	éžixei
odor: body or soured	žą́xta
odor: emanate an	brą́
odor: have a (good or bad)-from heating	táabrą
odor: have a stinking	žą́ąže
odor: sour	zą́zi
off	ekǫ́įke
off: get (e.g., a horse)	ósi, wísi
off: switch	ðuutáaži
off: take - a garment	ðiištówe
off: take-a person's clothes	ðuušáwį
off: take-by pulling	ðiištówe
off. throw (suddenly severing or moving s.t or s.o from s.t)	okáxpa
off: turn	ðiista, ðuutáaži
off (s.t round or sitting)	įkšítxą
off in the head	pxáðaži
off target	ekǫ́įke
off the record	ákahahta
off the subject	ée htáhaži
offend	ílaną
offensive smell: have an	ɣoį́
offer: make an - manner	íðilą ðįké
office	waðíhtą
officer	áhkita, áhkita totą́hąka
officer or other white person of rank	mą́ąhį htą́ą
"off-tribe" (tribe other than Osage)	ohkíhce
oil	wéil
oil well	átahką wéli níini
oily	ðóðo
ointment	stáðe
old	kóoci
old: be ~	nǫ́ǫ
old: get ~	ónǫ ahí
old: how ~ ?	omą́įhka háaną
old age	nǫ́ǫ, ónǫ
old and stacked or piled	kóoche
old folks, the old ones	haašíhta, kóoci, nǫ́ǫ, nǫ́ǫwaapi
oldest	htą́ą
old-fashioned	kóoci
old-time	kóoci
Omaha (tribe or tribal member)	ámaxa, omą́hą
on	á-, ki
on: put ~	álą
on: put ~ (e.g., pants, shoes)	opáahą, otxą́
on: put ~ one's own pants or shoes	okítxą
on: put ~ oneself (e.g., a shirt or a dress)	óhkioolą́
on: turn ~	káaɣe
on (something lying or spread out)	kši
on and on	nąną
on one's own	éwažį
on time: never ~	ókxąži
on top	ákaha
once upon a time	kóoci
one	wį, wįxce
one another (see reciprocal prefix)	
one of several, one to be chosen among many	ą́mą
one of these	ðéeka wį
one's own (see suus prefix)	
ongoing (recurring one after another)	ótxątxą
onion	mą́ąžąxe
onion: green ~	mąąžą́xe htóho
onlookers	wahtǫ́pe
only	na, ną́ški
only (one): be the ~	eená
only I	wíną
only this much	káaną
only to a limited degree	to
ooze	žé
open (adjective)	íðoce
open (intransitive) (e.g., a flower)	opáaɣa
open (transitive) (e.g., a door or a box)	ðiišupe, ðuuáze
open (transitive) (e.g., one's eyes or arms)	ákabra
open out	paaɣáce
operate on (perform surgery on)	hpáce
operation: place in ~	ðuušką́
opinion: hold an ~ of something	ažį́
or	ąži, ímąðe
orange (color)	zí žuuce ékǫ zí žuuce ékǫ
orange (fruit)	hką́ące zi
orbit	óžąke
order someone not to (do something)	ížoši
ordure	įlé
ornery	óškika
orphan (noun)	wahǫ́įke
Osage (tribe, tribal member, or language)	wažáže
Osage language	wažážeíe
Osage orange	mį́ceštá hu
other	ą́mą, éeži, ímą, ímąkše
other: the ~ (one of two)	ą́mą
other (different)	éeži
other (one)	ímąche
other side: (location)of the ~	áðahtaha
other side: on or to the ~	mąchéhta, mąsį́ha
other side: on the ~	ákahahta, ámąhta, ámąhtaha
other side: on the ~ of something	kootá
other side: turn oneself to the ~	ámąhta hkilíikoįɣe, hkilíisą
other thing: any ~	t́aatą éžiški
other things	táatą éžiški
other way	émąhtái, émąhtažíha
other way: turn oneself the ~	ámąhta hkilíikoįɣe, hkilíisą
otherwise	éeži, éški
otherwise: be ~	ékǫži
Oto (tribe or tribal member)	wažóla
other hide or skin	htónąke
ought to (see discussion under	ðáalį)
our(s)	ąkóhta, ąkóhtapi
ourselves (see relative prefix)	
out: be ~ (e.g., school for summer recess)	panáa
out: be ~ of	níðe
out: get ~ of (e.g., a vehichle)	ósi, wísi
out: give ~	wahkílai
out: put or set ~ (multiple items)	ážu
out: take ~ (unload)	oðúuxpaðe
out: toss ~	ǫ́ǫða
out of breath	íkaske
out of line	ekǫ́įke
outdoors, out-of-doors	ášihta
outer ear	nąąhtą́
outhouse	ožéhei
outset: at the ~	hpahą́le
outside	ášihta
outside of a certain area	ákahahta
outside of the main events or activity, outside of someone's social circle	ákahahta
outskirts: on the ~ of	ákahahta
outstanding: be	álįįha
oven	mą́ze oohǫ́
over: make over or do	kikáaɣe
over: put	ákaaspe
over: turn	ðiisáða, ipasq
over: turn (one's own)	liisą́ða
over again. (see inceptive prefix)	
over and above: be	álįįha
over and over.	šíną
over and over. turn - (transitive).	ðusą́sąwį
over here.	ðeeká ci
over there.	ée htáha, kaaðó, kootáįke
over there. farther -	kootá
overall.	bróka
overalls.	oðókiną́ąžį ákaha
overbearing.	ópaašike, tóekǫ́ži
overburdened. be -	íibrąxcį
overdue.	wascúuce
overeat.	tóoceha
overeater.	tóoceha
overseas.	níimąse
oversee.	oðóðe
oversee an event.	oðówaðe, óohkihą
overweight.	lą́ąðe
overweight: be -	wašį́
overwhelming.	hóšechie
owed. something -	weúuze
owl.	wahpóka
own (my own, your own, his/her own, our own, their own, one's own).	(see suus prefix)
own (possess).	aðį́
owned by, be -	íhta
Pahsetopa (a family name of the Osages).	hpásetoopa
pail.	céɣe
pain. experience -	níe
pain. suffering -	waxpáðį
pain in the heart: have a -	ðą́ąceníe
paint (N,V).	stáðe
paint the deceased, apply face paint.	kikˀǫ́
pair, couple, two of them.	nahkǫį́
paisley.	hpasúkoša
pal.	hcošpá
pallet.	omíže
palm (of the hand).	nǫǫpé
pancake.	wacúe bréhka
pane of glass.	okáhąpa
pant (verb).	heháha
pantry.	wánǫbréoožú
pants.	oðíkinąąžį, oðókinąąžį, wéhkiliį
papaw.	hį́įce hu
paper.	htaną́kˀa
paper: toilet -	íkahci
paper containing text.	waléze
paper money.	htaną́kˀa, htaną́kˀa mą́zeska
paper napkin.	htaną́kˀa ípukxa
paper towel.	htaną́kˀa ípukxa
parallel (to).	páskuha
parasol.	(see discussion under oðíni)
parents: your -	ðiihǫ́ ðitáce
parrot.	wažįkaíe
part: be a - of	oðízą
part (of the whole).	hépe
part in the hair.	hpióka
pass (transitive).	húkaaɣe
pass air (gas).	ðiipíɣą
pass around.	ákiɣe, ápše
pass away (e.g., the drum at ilǫ́ǫška dances)	kaaðée
pass away (euphemism for 'die').	xíða
pass away (varnish)	ðįké
pass back and forth.	ihkílašą
pass by	ákiɣe, ípše
pass by hand.	kˀú huu
pass gas.	ðiipíɣą
pass something too someone (e.g. at the table).	kˀú
pass the drum.	céɣenii ðée káaɣe
pass to (by hand or other means).	húðe
past (in time).	álįįha
past. go -	ípše
past. in the -	haašíhta
past the next: the one -	kootáha
path, pathway.	óžąke
path: along a -	ha
path: along a - to a hearer	šeeðǫ́ha
path: on the - to a certain point.	htáha
pathway: by what -	howaįkíha
patter (verb).	xée
pause.	panáa
Pawhuska.	hpahį́įska
Pawhuska district, Pawhuska Osages.	waxákaoliį́į
Pawnee (Indians).	hpaðímaha, hpáðį
pawpaw.	htóžąke [archaic meaning], htóžąke eekǫ́
pay (a debt).	kašúpe
pay attention to.	óðąąceši
pay back.	kíšupe
pay for (a purchase).	kašúpe
pay someone, pay for someone	kíšupe
pay attention: act of -	nąąɣúce
payment.	wahkílai
payment: cash -	wahkílae wakášupe
peaceful.	škaškáða
peach.	hką́ące hį́įšce
pear.	hką́ące hpá álą
peas.	hǫ́brį́ke htóho žį́
pecan nut.	watástosta
peel (verb).	ðiilóce, ðuušáake, páašpue
peep into, peer in or into.	okácˀį
peeved: be -	óla
pemmican.	htáapše
pen.	wapáleze, wéleze
penalty.	ílanąwakíšupe
pencil.	wapáleze, wéleze
penis.	šǫ́ce, žé
pennies (small change).	ošpéžį, waðáawažį
penny	waðáawa žúuce, waðáawažį
people.	níhkašie, níhkašika
people: little - (small beings in Osage mythology).	míalǫška
people: many or a lot of -	huukǫ́ða
people gathering with each other.	hkilíiski, waðíiski
pepper.	mąhkáhpa
pepper: black -	mąhkáhpa sápe
pepper: red -	mąhkáhpa žúuce
pepper shaker.	mąhkáhpaóožu
perch (fish).	hó bráaska
perform.	káaɣe
perform surgery on.	hpáce
perfume.	wabrą́lį
perhaps.	ska
permanent (adjective).	saakí šǫǫšǫ́we
perplexity.	ókˀą wanąðaži
persecute (an animal or person).	ðiihíce
persimmon.	wastą́įke
person.	níhka, níhkašie
person: become or live as a -	ínihkašie
person: young -	hcéka nǫ́ǫ
person of mixed blood.	įįštáxįžį́
person of unsound mind.	waðíla eekǫ́ įké
person who cooks.	oohǫ́
person who is always making people laugh.  	wahóhota
person who talks too much or too long.	íe scece, íeštą
person who tells everything.	táatąžį́ ški oðáake
person who won't stay home or seldom stays home.	wáaspaži
personal name in the Eagle clan (mǫ́žǫ)	mą́žą
personal name (perhaps that of Charlie Pasetopah).	hcí tóopa
personality, personal characteristics.	ókˀą
perspire.	paɣíce
pestle.	wépše
petiton.	waatá
Petsemoie (family name).	hpéece mąðį́
Petsemoie: Herman - (personal name: Daylight Approaches).	hǫ́ǫpahu
peyote.	wanǫ́bre
peyote: have one's body affected by -	mą́hkažóika
peyote meeting.	hkihkǫ́ze, mąhkáðaaché
peyote or any other kind of medicine.	mąhká
peyote song.	hkihkǫ́ze waaðǫ́
peyote tea.	wanǫ́brenii
pharmacist.	mąhká aðį́
phlegm.	hóxpe léle, íli
phone (noun).	mą́zeie
phone: call by -	mą́zeie híðe
photograph.	įcé waléze
physician.	wahkǫ́taki
piano.	paakíce
pick (choose).	hkíhpaahi
pick (e.g., flowers or fruit).	paahí
pick fruit.	ðuuzé
pick or pluck (e.g., a chicken).	ðuušáake
pick people (or things?).	wapáahi
pick up.	ðiihą́, hkíhpaahi
pick up (many small scattered things).	paahí
pickle.	hkohkóma
picnic (verb).	ášihta wanǫ́bre
picture of anything.	įcé waléze
picture show.	ówatoį
pie of any sort (fruit, cream, etc.).	hkąącóolą
piece.	hépe
piece: small -	ošpéžį
pig.	hkóhkosa
piggyback: carry -	ðuškápa
pillow.	į́pehi
pillow to sit on (as for a sofa, chair, or other seat).	wákaštǫ
pillowcase.	íphiį oðíši, oðíši
pin (ornamental).	wápaɣa
pinch (verb).	ðilǫ́ke
pinch off (e.g., in making balls out of cornmeal for cornmeal dumplings).	kaaskí
pine wood, pine tree.	páze hú
pipe.	nąnį́ǫpa
pistol.	wahóotą, wahóotą táahpa
pitch (and other card games).	oðáake kˀǫ
pitcher (container).	níioožú
pitiful.	lažį́į, waxpáðį
pity (verb).	ðakˀéðe
pity; show or use - with.	íðakˀeðe
pity each other.	ðakˀéhkiðe
pity one's own or someone close.	ðakˀékiðe
pity oneself.	ðakˀéhkiðe
place: at their ~.	eeí pa
place: be at that ~.	eeí
place: in ~ of.	(see dative prefix)
place a baby on the baby board or inside.	hpáaž̨̨įokˀǫ́he
place a standing item on a surface.	khícheðe
place above.	mąšíhta
place an item upright on another item.	ále
place at which.	ó-
place in operation.	ðuušką́
place inside of.	oolą́
place into.	okˀǫ̌he
place multiple items on top of something else.	ážu
place right next to the hearer: to a ~.	šeeðǫ́ha
place something or someone first.	hpahą́le mąðį́
place something up or above.	ámąši
place to bathe.	ohílða
place to live.	oheíle
place together (as when cooking two or more items together).	oðóhkiðe
place two or more things together and tie them.	paaxcé
place upon or on.	álą, álj̨j̨
place vertically against.	álą
plain: make ~.	wáðaaska
plain: make things ~(e.g., words, lines upon a paper, bordes on land).	wáðuuska
plant (e.g. seed in the ground).	oožú
plant stuff.	oožú
plant to mix with tobacco (a small, sweet-smelling plant with yellow flowers that is mixed with tobacco).	nąnúhu íkiahį
planting.	ówe
plants: "put in" ~.	oožú
plat.	mąžą́waleze
plate.	hį́įce
platter.	hį́įce apakˀą́, hį́įce braaka
play (intransitive).	škáce
play (transitive).	kˀǫ́
play a card (in a card game).	ðée káaɣe
play dice.	kˀǫ́sukˀǫ́
play a horn or other wind instrument.	opíɣą
play a joke on.	ðíhota
play cards.	htaną́kˀa kˀǫ́
play golf.	htaapéskažįkˀǫ́
play music on an instrument.	paakíce
play slyly or meanly with.	ðiihíce
play with someone related to oneself or animate being of one's own.	kiškace
play with something	ðiihíce
player: tape ~.	mą́zeie
playing cards (noun).	htaną́kˀa, htaną́kˀa ðiihíce
pleased with; be ~.	kiðálį
plentiful.	ochí
plentifully: exist ~.	ochí, óše
plenty.	kaakǫ́ną, oše
pluck (e.g., a chicken).	ðuušáake
plum.	hką́ąc xóce, níižue hką́ące
plural marker.	api
plus.	éci
pneumonia.	ðúwenie
pocket. 	óožu
pocketbook.	mą́zeskaoožú
point at, point to.	ápazo
point (in a game).	pázo
point (of an object).	hpasú
pointing finger.	wéapazo
pointless, pointlessly.	ée ht́ahaži
poison.	mąhká hpíiži
pokey (slow).	wascúuce
pokey one (slow person).	ošcúuce
pole.	žą́ą žą́ąxe, žą́ąxežį
pole: fishing ~.	hóize žą́ąxe
police.	áhkita
polish. 	(see discussion under ápuštai)
pollute (e.g., water or air).	ízizike káaɣe
Ponca (tribe or tribal member).	hpǫ́hka
pond.	niitáahpa
ponder.	waðílą
pony.	hkáwa
ponytails (one on each side of the head).	héðǫǫpa
poor (of poor quality).	hǫ́ǫži
poor (pitiful).	lazšį́į
poor (poverty stricken).	waxpáðį
poor: be ~, do something poorly.	oolą́ąži
poor performance: make a ~ of.	oolą́ąži
poorly.	hǫ́ǫži
pop (e.g., a balloon).	kaapxóhke
pop: soda ~.	niikáapxohke
pop bottle or can.	niikáapxokeoožú
pope.	šǫmį́hka kahíke
porch.	ánąąhkoe
porcupine.	hpáhį
pork.	hkóhkosa
pork fat.	hkohkósa wéli, wéli
porter. hei'z;epe ahkita	heížepe ahkita
portion that fills approximately half full	ohépe
portly	šį́htąką
portrait	įcé waléze
position (occupation)	oðihtą
positional articles [positional]	che, ðe, jkše, ke, kše, pa, pe, txą
positioned so that it surrounds a part of the body: have something ~	į́
possess	aðį́
possession: come into ~ of	okšéhtą
possible	ðąąché
possum	sį́šta
posterboard containing text	waléze
pot	céɣe
pot: cooking ~	óohǫ
potato: white or Irish	tóoska
Potawatomi (tribe or tribal member)	wahówahá
potential marker	hta
pouch: tobacco	nąnįǫ́kužu
pouch made of hide or leather	óožuhaa
pound (verb)	pšé
pound, (measure of weight)	íðuspa
pour	ólą
pout about another's good fortune	óxįį
poverty stricken	waxpáðį
power	waašką́
practice (noun), practice session	íkˀuce
prairie	zą́ą, zą́ące
prairie chicken	mǫ́nǫį
prance	ðiheíceðe
Pratt: Henry - (personal name)	nǫ́ǫhpewaðe (specifically, variant from nǫ́ǫhpewali)
Pratt: Henry ~, JR. (personal name)	xǫ́ǫce mą́į
pray	waatá, wíkie
pray for	kíwaata
pray for oneself, pray for each other	waahkíhta
pray for someone or s.t	waatá
prayer	íe, waatá, wíkie
prayer: closing of a ~	kaašeną
prayer neads	́wikie hį́įska
praying mantis	waluška įįštá htą́ka
preacher	ožą́ke olį́į, wahkǫ́ta íe oðáake, wahkǫ́taki
precede	hpahą́le ðée
precious	hcéxi, óxta
precious: consider ~	óxta káaɣe
precious: make ~	óxtaðe
precisely	xci
prepare	káaɣe
prepare (e.g. food)	oohǫ́
prepare a feast for another or others	kíkxo
prepare for someone (e.g. food or a bed)	kšíɣe
president	ihcíkoapí
press something (e.g., cloth with an iron).	wapúštaha
press together.	ðiikíke ́
pressing, by ~.	paa-, pu-
pretend.	kǫzé [JOD, LFD]
pretty.	ðáalį
pretty: very.	ohtáza
prevail upon someone to do something	waší
prickly.	waxáka, xáka
priest.	ožą́ke olį́į, wahkǫ́taki
prior.	hpahą́le ́
prize something	kiwaiį
probable.	ðąąché
probe.	ákazo
problem.	óie
problem: discussion of a ~.	óie
proceed.	ékiǫ
proclaim.	oðáake
produce: garden ~ (vegetables).	ówe, wasúutą
profusion.	óše
program: put on a ~.	ókˀą
prohibit.	ižoši
promise-keeper.	íe okípše
pronounce.	ðaacé
proper, properly.	wáðohtą
proposal or proposition: make a ~.	táatą paahą
propose.	hce ée
prostitute.	wakˀó nǫǫhǫ́
protrude.	ðuhtáža
protuberance.	hpá
proud, proud of.	óžo áži
proud: be ~ of one's own.	óžo ákižį
proud: be ~ of oneself.	óžo áhkižį
provide.	okˀú
provide for.	wakˀú
provide that.	tą
prune.	hką́ące sápe
Pryor; Antoine (personal name: Gentle Man)	níhka watą́įke
puff, puff on	ðaahtą́
pull	ðaahtą́
pull (e.g., a tooth) to remove it	ðiíštowe
pull apart (e.eg., a tree limb from a trunk)	ðupáxa
pull dirt over	áðikˀo
pull down	ðuuhúuce
pull off	ðiištówe
pull out (e.g., all of one's hair)	ðuušáake
pull over to cover	áðuzu
pull to, pull shut	áðiitą
pull up	ðuumą́ši
puma	itǫ́eži
pumpkin	watxą́
punch	paaspą́
punch (e.g., - someone on the side of the head)	kaabráze
punch a hole in	opákˀo
punch through	kaascú
punching: by -	pó-
punk (tinder)	žąąhcúkˀa
puppy	šǫ́žį
purchase	ðuwį́
purple	htóho sape, žúuce sápe
purse	mą́zeskaoožú, wá́seska
push along, push someone or someone steadily	paaɣówe
push aside	kaacį́že
push down on	apisą
push someone onward	hpánąąke
push to awaken or make active	paaɣí
push to drunkenness	páalǫðį
push two or more things together and tie them	paaxcé
pushing; by -	paa-
pushy	ohesaži
put (e.g., a baby on a baby board)	okˀðhe
put a pourable substance on something else	ážu
put an end to something	kaaštą
put away to keep	kícheðe
put clothes on oneself	óhkioolą
put down	hkícheðe
put each other to a test	áhkiasąci
put in	oožú
put into	okˀǫ́he, oolą́
put on: cause someone to or make someone - an article of clothing	įkšíðe
put on (e.g., pants, shoes)	álaha, oną́ąžį, opáahą, otxą́
put on (place on)	álą
put on clothing (not one's own)	wéhkilį opáahą
put on clothes (one's own)	wéhkilį okíhpaahą
put on one's own pants or shoes	okítxą
put on oneself (e.g., a shirt or dress)	óhkioolą́
put on the head	oolą́ke
put out (multiple items)	ážu
put over, put upon	ákaaspe
put someone in jail	hą́ąnahpazé oolą́
put someone to bed	áðižą
put stuff in	óožu
put to the test	ásąci
putrefied	tožaðe
quack (like a duck)	hóohtą
quail	óšechiðe wakáaɣe, žǫhpáleze
Quapaw Indians	okáxpa
quarrelsome	taakéštą
quarrelsome: feel -	hkížį
quarter (25-cent piece)	kašpéǫpa
queen (in a deck of cards)	wakˀó, žekážįka
queen of spades (in a deck of cards)	mą́ąhįsu wakˀó
question about one's own people or things	ilǫ́ɣe
question someone	iðǫɣe
question something verbally (as in a business meeting)	óie
quick to do things, quick-acting	wahtóke
quickly	óhesaži, wakóo
quiet	níažį, šká
quiet: be -	oní ðįké
quiet (not in movement)	šką́aži
quietly (not in movement)	šką́aži
quill	súhkahtąą mǫ́šǫ
quilt	óhkiache, omíže
quirt	wékaaži
quit	kaaštą́, panáa
quit someone	ǫ́ǫða
quit someone (divorce or separate)	ǫ́ǫðe
quite a while: for-	kaahúuža
quiver	ðibrúbruɣe
rabbit	mąšcį́ka
raccoon	mį́hkaa
race (noun)	hkipáną
rack (barbecue rack)	oážu, wážu
radio	htaacé oðį́įke, mą́zeie, wéhice aną́kˀǫ
radish	hpǫ́ɣe
ragged	cúuða, xúuða
ragweed	mąąhį́hpa
rain (n, v)	níižu
rain: fine -	níižu xóhtą
rain, gray -	níišoce, niižú xóce
rain: light -	niižúžu
rain: misting	íhkišoce
rain lightly	nuužúžu
rain shower	níižužį́
rainbow	htoníle
raindrops: fine -	níižu xóhtą
raise (e.g., a flag)	paamą́ši
raise (lift)	ðuhpáahą, ðumáða, ðuumą́ši, paahą́, paamą́ši
raise (rear)	nǫ́ǫðe
raise someone or something	ðiihą́
raise up	ðumáða, opáahą
raise us, those who -	nǫ́ǫwaapi
rank and authority: one with -	totą́ha
ranking member	totą́ha
rape (verb)	mąąðǫ́
rat	įchóhtąą
rate: at any -	óðąži
rather (adverb)	́ékǫ
rather (conjunction)	kóe
ration (give out in portions)	ínkilai
rations (food)	ǫ́nǫbre
rations (from the government)	wahkílai
rattle: gourd -	hpéɣe
raven	hkáɣe, hkáɣe htą́ka
raw	cúutaži
reach as a location or place	achí
read (transitive)	ðaacé
reading	walézeáace
ready (adjective)	háha, íðiištą
ready: be -	ðiištą́, íhice
ready: get or make oneself -	háhahkie
ready oneself, get oneself ready	hkíliištą
ready to pick or harvest	súutą
real	xci
really	wálį, xci, -žį
rear (raise)	nǫ́ǫðe
reason: out of - (unreasonable)	ée htáhaži
recent, recently	hcéka
recent, the most -	ce
receptacle	oožú
recess (verb)	panáa
reciprocal prefix (recip)	hkik-
recite	oðáake
reckless	íinǫǫhpaži
recline	áðiikxą, áðiikxą žąą
recognize (a person)	ípahǫ
recognize oneself (as)	íhkihpakǫ
reconsider	oðóhake íðilą
record (make a recording with an audio device)	íe ðuuzé
recorder: tape	mą́zeie
record-keeper for tribal council	waléze káaɣe
recover (from illness)	kiní, kítąhe
recover consciousness	hkilázo, iihkíðe
rectitude: an act with -	óðohtąhkiðe
rectitude: acting with -	óðohtą
rectum	įléha
recuperate	kiní
recurring one after another	ótxątxą
recurringly	ną [ittratįe], nąpe
red	žúuce
red: dark -	pazó ekǫ́
Red Eagle (name for first boy in hcížo clan	xuðážuuce
Redeagle: Jeanna - (personal name: Looking Eagle)	xúe tǫ́į
redo	kikáaɣe
reduce (transitive)	čóopa ekǫ káaɣe
reduced quantity	wahókˀa
reflexive possessive (see suus prefix)	
reflexive prefix (refl)	hkik-
reform (verb)	kikáaɣe
refrigerator	ną́ɣeoožú
refuse to do something	ížoši
refuse to talk	íeži
regain consciousness	iihkíðe
regard as holy	óxta káaɣe
regard each other as friends or relatives	ðótahkiðe
regardless	óðąži
regulations	wahkílaace
regurgitate due to overeating	ókohpa
reimburse	kišupe
reimburse (for)	wakíšupe
reject	ðuuzaži
relate (narrative)	oðáake
related: be -	ðótahkiðe
relatives: regard or take each other as -	ðótahkiðe
relax	hkilázo
reliable	wáðohtą
relive someone of their clothes	ðuuštáke
reluctant to do something: be -	ížoši
reluctant to share something of one's own	kíwalį
rely on	íkinaaži
remain	ošcé
remainder	ošcé
remainder (singular standing inanimate, or plural sitting inanimate)	ošcé che
remainders (scattered around)	ošcé ke
remaining	ošcé che
remedy (verb)	ðuðáalį
remember	kisúðe
remove	ðicíze, ðuxpáxį
remove a garment	ðiištówe
remove, as from office.	ǫ́ǫðe
remove by pulling.	ðiištówe
remove from (e.g., remove a kettle from a cooking fire).	šíle
remove some substance from a surface.	kaací
remove something by extracting or lowering it.	oðúuxpaðe
remove the hide from anything.	ámaxa
rent (noun).	ootá mą́zeska
repair (verb).	kikáaɣe
repair for someone	kšíɣe
repay.	kíśupe
repay for.	wakíśupe
repeatedly.	háachi, íkiha, ną [ITERATIVE], štą
reportative markers.	áakxa, áapa, áape
represent (as an attorney at law argues on behalf of a client).	ákhie
representative: congressional~.	hkiistó omąðį
representative (in legislature).	wahkílaace káaɣe
reprimand (verb).	kaazą́
request (verb).	tá
request marker.	hce
request something	waatá
request that someone do something	íihǫ
request to borrow something	ootá
resembling each other.	kǫzéhkihkǫ
reside.	hcíle
resound.	xowí
respect (verb).	ðixópe, kíxope, ókˀą axópe
respect: address folks with~.	óxtahkiðe
responsibility: have the ~ for s.t specific in response to a formal request (e.g., taking care of the food for an event).	okášą
rest (verb).	áðiikxą, áðiikxą žą́ą, hkikˀą́zehkiðe
rest: a night's ~.	žą́ą
rest: at ~.	škaškáða
rest (remainder):	ošcé, ošcé che
rest (remainder, scattered around).	ošcé ke
restaurant.	owánǫbrehcí
restrain by tying.	ðuušáwį
restraint (such as a bridle?).	wáapįce
retarded: "mentally ~."	cˀéka
rethink.	oðóhake íðilą
retrograde.	xáða
return here (motion accomplished).	alí
return home, return there.	akší
return home,return there (motion underway).	alée
return point.	ípaašąha
revere.	ðixópe
reverse (verb).	ðiisą́ða
reverse: in ~.	xáða
revile.	lǫ́ǫ
revile over and over.	lǫ́ǫlǫǫ
revolver.	wahóohtą, wahóohtąžį
rheumatism.	wahúni
ribbon.	háabrehka
ribbon work	wápaache
ribcage.	ðúwe
rice.	pósu
rid: get ~ of.	ǫ́ǫðe
ride horseback.	hkáwaalįį
ride in.	olį́į
ride in an airplane.	kį́į
ride on.	álįį
rifle.	wahóohtą
right (correct).	ékǫ, óxta
right, on the right, rightward, to the right.	íśtǫka
right: I guess that's ~.	ékǫ ska
right: just ~, just the right amount.	káaną
right: make oneself ~.	óxtahkiðe
right: not ~.	eekǫ́ ðįké, ékǫži
right: not get something ~.	ðikšį́ce
right: say something ~.	ékǫ ðaacé
right: that is ~.	ékǫ
right away.	wąkǫ́ǫžį
right mind: not in one's ~.	waðílą eekǫ́ įké
rigid.	sáta
rind.	háa
ring (intransitive).	hkaamą́, kaahtáama
ring (transitive), ring the bell.	ðuuhkáamą
ring (for wearing on the finger).	kaahtáama
rip (verb).	kaabráze
ripe.	cúuce, súutą
ripped (said of clothing).	cúuða
rise.	-hą, hpaahą́
risk (verb).	íkˀuce
river.	níižuuce
roach bone.	htaasį́įce wahú
roached hair.	hé káaɣe, hpaxáce
road.	óžąke
roadman, be a roadman.	ožą́ke olį́į
roam.	opáwįɣe
roar (verb).	xée, xowí
robbery.	wamą́ąðǫ
robe.	mį́
rock (noun).	į́į
roll (verb), rolling.	htą́ąða
roll a cigarette.	nąnį́ǫpa káaɣe
ride.	olį́į, opáwįɣe
ride: go for a ~.	opáwįɣe
room.	hcíohka
room (in the sense of an unoccupied area).	óhką
rooster.	súhka tóoka
root (of a tree, bush, etc.).	žą́ą kˀą
rope (noun).	wéðį
rope (verb) (e.g., a calf).	oðíiną
rosary.	hį́įskawáata, wíkie hį́įska
rotten.	tožáðe
rough.	ɣáɣaka, óhesaži, xáka
roughly.	óhesaži
round.	ðą [LFD], táahpa
round: make ~.	ðuutáahpa
round about this way.	ðeekáiha
rounded and squat.	čáahpa
rove.	opáwįɣe
rowdy: be ~.	taeðáalįži
rub off to efface.	púkxa
rude.	wakaacˀáiži
ruffled, ruffly.	xáxa
rug.	omíže
ruin.	ðuhpíiži
ruined	hǫ́ǫži
ruler (measuring stick).	žą́ą wéðaawa
rules.	wahkílaace
rumble (verb).	xowí
rumor.	ónąkˀǫ
rumpus.	óochiže
run (intransitive).	htą́ąðį, ną́ąke
run (as a liquid).	stówe
run away, run off.	hkóopše
run in a competition.	hkipáną
run into.	áhkoopše
run off.	olé
run off (on someone).	kíhkoopše
run out of breath from.	íkaske
run water (e.g, into a bathtub).	ðixtą́, ðuuzé
run wild.	taeðáalįži
running as a group.	ostówe
running here and there.	cˀélǫðį
Running Man (personal name).	níhkahkipáną
runny nose.	hpahlíxtoe, hpalį́
rupture (hernia).	hcéze bráze
rushed.	wahkǫ́i
rushed: being ~, rushing in a row.	ostówe
Sac and Fox (tribe or tribal member).	sakí ho, sakíwa
sack (bag).	óožuhaa
sacred.	hcéxi, xópe
sacred: hold ~.	ðixópe, óxta káaɣe
Sacred Arrow Shaft(personal name for a female).	mą́ąsihcexi
sacred object.	waxópe
sad.	kíhpiiži, kízoži
saddle.	ną́hkai
saddle blanket.	wákaštǫ
safely.	óhtaiðįke, ókašéįke
sage (sage bush or sagebrush).	hpéže
said: it is ~.	(see reportative markers)
salary.	okšéhtą
saliva.	íli
saloon (bar).	hpéeceniihci (old meaning), hpéecenii ðaahtą́ hci
salt.	níiskue
salt pork.	wašį́
salt shaker.	níiskueoožú
same: the ~ as.	kǫzékǫ
sand.	hpuzá
sand-in-eyes.	įcóolą
sandwich.	htóolą
sash.	íhpią [LFD]
Satan.	ilǫ́ɣe
sated or satiated: be ~ with.	íibrą, wéenące
satiated with food: cause oneself to be ~.	wéenącehkiðe
satisfied.	škaškáða, waðílą ðáalį mąðį́
satisfy oneself with food.	wéenącehkiðe
Saturday.	hą́ąpa ókaaɣéįke
sauce: sweet ~.	waskúe
sauerkraut.	mą́ąsase
sausage.	tǫ́ǫpše
save (as a memento or treasure).	kícheðe
saved: place or condition of being ~ (in religion).	ónihkaši
saw (for cutting wood).	žą́ąpaase
saw or other tool for cutting wood.	wépaase
say.	ðaacé, ée, ékie, íe
say bad things about someone	hkiláažoži
say bad words.	lǫ́ǫ
say nothing.	íeži
say so.	oðáake
say something right or correctly.	ékǫ ðaacé
say the name of something or someone	ðaacé
scales (for weighing).	íðuspa [LFD]
scarecrow.	níhkaši íkǫske
scared: be ~.	nǫ́ǫhpe
scared: be ~ of.	íinǫǫhpe
scarf.	haaléžowaake
scary.	nǫ́ǫhpewaðe
scatter (trans. and intr.) (e.g., corn for drying).	okábra
scheme against someone secretly.	nąlǫ́ǫha
school	taapóska, walézáace
schoolhouse	taapóskahci
schooling	walézeáace
scissors	hpahúuse
scissortail	ǫ́pežahta
scold	kaazą́
scold harshly	toniðe
score (points in a game)	pázo
scorekeeper	waápazo átǫpe
scouting, scouting alone	totą́
scrambled (e.g., eggs)	niľǫze
scrape aside	kaacį́že
scratch	ðikˀiðe
scratch an itch	kˀúe
scream (verb)	pą́
screw (have sex with)	aðį́ažą, chúe
scrotum	šǫcóso
sea	níi htą́ka, níimąse
search for (something lost or misplaced, something of one's own, or something belonging to someone else)	okíce
search for something or someone	océ
search for stuff	óce
seat (noun)	áalįį, álįį
seat: take or occupy a ~	olį́į
seated: be ~	olį́į
second	wéðǫǫpa
secret: in ~	ákahahta
secret society	nǫ́hǫžį
secretary	waléze káaɣe
secretly scheme against someone	nąlǫ́ǫha
see (intransitive)	wawéeðe
see (transitive)	íiðe, tǫ́pe
see about	oðóðe
see each other again: means to ~	wéehkile
see people or events	watǫ́pe
see someone	kitǫ́pe
see things (as in a dream or hallucination), see multiple things or persons one after another	wawéeðe
see to	okáše
seed	súu
seems: it ~ that	ska
seesaw (verb)	sísiąðe
seize	oðį́įke
select	ðuuzé
select by pointing to	ápazo
select for oneself	hkíhpaahi
select from one's own people or items	kíhpaahu
select (people or things?)	wapáahi
selfish	wáli
selfish: be ~ with	kíwalį
sell for	íðuwį
sell something by bartering for other stuff	wéðuwį
senator	hkiistó omąðį
send, send by mail	ðéeðe, ðée káaɣe
send by wire, send there by telegraph	mą́zekˀąsaaki ðée káaɣé
separate (as a couple)	ohḱiǫðe
separate, separated (e.g., an estranged couple, egg yolks from whites)	kíðahapa
separate: be ~	kíðahapa
separate: become ~ from	ohkíǫðe
September	mį́įǫpa lébrą hce wį́įke, taapóska mį́įǫpa
serpent	wécˀa
serve (liquids or pourable solids such as beans)	oožú
set: go ~ (as in a card game)	ðuucˀáke
set aside	kícheðe
set down	hkícheðe
set fire to	ośai
set off (e.g., set a kettle off a cooking fire)	šile
set on (e.g., set a kettle on a fire)	ále
set out (go)	aðée
set out (multiple items)	ážu
set on a new task under one's charge	okášą
seven	hpéeðǫǫpa
seventeen, seventeenth	lébrą álįį hpéeðǫǫpa
seventy, seventieth	lébrą hpéeðǫǫpa
sever by striking with	íkaase
several days: for ~	kahą́naže
sew (intransitive)	wapáache
sew (transitive)	páache
sew things together	wapáache
sewing	ópaache, wapáache
sewing machine	mą́ze wépáache
sewn, sewn together	ópaache
sex: have ~	wachú
sex: have ~ with	aðį́ažą
sexual partner: take as a ~	ðúɣe
shack	hcí hpíiži
shackle	paaxcé
shade: window	akáaspe, okáhąpa akáspe
shaded	šápe
shadow	hkeetáxe
shake (intransitive)	ðibrúbruɣe
shake (transitive)	ðusą́sąwį
shake (a person, an object, or one's own body part)	ðižáža
shake hands	šáake oðí̌ǐke
shake one's own (body part or possession)	ližážai
shaker (container)	oožú
shallow	xépe
shame (noun)	wawéešce
Shannon: George ~ (personal name: Aroused by Something That Suddenly Appears)	wakáahcį́e
sharp	hpaahį́́
sharp edge: by using a ~	pá-
sharpen	ðiimǫ́
shatter (intransitive)	kaaléke, léke
shatter (transitive)	kaaléke
shatter by cutting or using a sharp edge	páleke
shatter by foot or with the foot	nąąléke
shatter by pushing outward	paaléke
shatter by striking or sudden movement	kaaléke
shatter one's own	kíleke
shatter with the hands	ðuuléke
Shattered Forehead (nickname)	hpéeleke
shave the head	kaacˀó
shavings	sase
shawl	haaskámį
Shawnee (tribe or tribal member)	šáwanįį
she too	eeškítą
shears	hpahúusehtąą
sheathe	okˀǫ́he
sheep	htaaská
shinny stick, the curved stick used to play kasini (shinny)	ohkíce
shiny	xą́xą
shiny and smooth (as a lake surface)	štáha
ship	páce
shirt	haaská
shit (defecate)	žé
shiver	ðibrúbruɣe
shoat	hkóhkosa
shock	ðusáaki
shock someone	hóšechie
shock someone(as with suddenly emerging news)	pólǫðį
shocked	pólǫðį
shocking, shocking news or report	hóšechie
shoemaker	hǫ́ǫpekaaɣe
shoes	hǫ́ǫpé
shoot (a gun or bow and arrow), shoot at	hkúce
shoot at each other, shoot each other	hkihkúce
shooting: by ~	pó-
shop (commercial establishment)	watǫ́ehci
shop, (go shopping)	waðúwį aðée
short, short and small	čáahpa
short distance: a ~ away	áška
short of breath, shortwinded	hehé
shot: administer a ~	mąhká oðíkˀe
shotgun	wahóohtą
shotgun: breechloading ~	wahóohtą opáaxǫ
shoulder	ábro
shoulder blade	áahu
shout	hóohtą, pá
shove, shove someone's head quickly in anger	taašéðe
shovel	hcúke
show (intransitive)	heį́į, wahcį́į
show (noun)	ówatoį
show someone how to do something	kǫ́ze, kšíǫze
show things	táatą paahą́
shower (of rain)	níižužį́
showing: be ~	wahcį́į
shroud	haažúuce
shut: pull ~	áðiitą
shut (e.g., one's eyes)	ápisą
shut by pulling	áðiitą
sick: be ~	íhpiiži, íhuheka
sick: be ~ from	ǫ́ǫ
sick: be ~ with	íhpiiži, íhuheka
sick: make ~	húheka káaɣe
sick from eating too much	ókahpo
sick with fever	áachi
sicken (transitive)	húheka káaɣe
sickly	ókawai
sickness	húheka, óhuheka
side: (on the) other ~	ákahahta, ámąhta, ámąhtaha
sides: take ~ with respect to someone	íkie
sieve: grain ~	wacúe ikaažį
sigh (as wind through trees)	xowí
sight	wawéeðe
sight: have normal ~	wawéeðe
sign (e.g., a document)	šáake oðį́įke, žáže kikáaɣe
sign with a thumbprint (in lieu of a signature)	íkuspe
signature	žáže, žáže wéleze
signature: affix one's ~	žáže kikáaɣe
signify	ékǫ
silly: talk someone ~	páalǫðį
silver	mą́zeska
similar in appearance to	íkǫska
similar to	ékǫ
since (because) (often not expressed directly, but implied by the logical or pragmatic relationship of one clause to another; for examples, see under tasli 'burn', toa 'some', weena 'be thankful, grateful', wehice 'far')****	tą
sing	waaðǫ́
sing (like a bird)	hóohtą
sing dancing songs	xóhka
singer: be a ~	waaðǫ́ hpíǫ
singers and drummers	xóhka
singers: female ~	oðáazo
singers of dancing songs, singers at a dance	x́ohka
singing: be skilled at ~	waðǫ́ hpíǫ
single	ohką́ci, wį
single (unmarried) person	kažą́si [JOÐ]
single item or event: that ~	wįįðé
Sioux (tribe or tribal member)	hpápaxǫ
sister: baby ~	asíhpa
sister (specifically, older sister of female)	wižǫ́ą
my older sister (speaker is female)	wihtą́ke
your older sister (addressee is female)	ðižǫ́ą or ðihtą́ke
'her older sister' sister (specifically, older sister of male)	ižǫ́ą or ihtą́ke
'my older sister' (speaker is male)	wihtą́ke
'your older sister' (addressee is male)	ðihtą́ke
'his older sister'	ihtą́ke
sister (specifically, younger sister) - my younger sister	wihtéžį
your younger sister	ðihtéžį
his/her younger sister	ihtéžį
sister-in-law (specifically, sister-in-law of male)- 'my sister-in-law' (speaker is male)	wihą́ka
your sister-in-law' (addressee is male)	ðihą́ka
'his sister-in-law' sister-in-law (specifically, sister-in-law of female)	ihą́ka
'my sister-in-law' (speaker is female)	wisíkxą, šíkxą
'your sister-in-law' (addressee is female)	ðisíkxą, šíkxą ðíhta, ðisíkxą
'her sister-in-law'	isíkxą or šíkxą
sit	lį́į
sit down	lį́įke, olį́į
sit in a place	olį́į
sit suddenly	lį́įke
sit upon	álįį
six	šáhpe
sixteen, sixteenth	lébrą álįį šáhpe
sixty, sixtieth	lébrą šáhpe
skilled: be ~ at	hpíǫ
skilled: be ~ at doing things	wahpíǫ
skillfully	ðáalį
skin (verb) (as an animal)	ámaxa
skin(of an animal)	háa
skin(of an animal): thick ~	háa šooká
skin(of a person or animal)	xúhaa
skinny (e.g., a person or a tree)	lažį́į
skirt: wraparound ~	wáakipetxą
skirt with ribbon work or other decorations	wáache, wáakipaache
skirting the edge of something	ákiɣe
skunk	mą́ka
sky	mą́ąɣe, hkéðo
slam (transitive), slam closed	kaasį́ce
slam on something	ákaasį́ce
slander (verb)	hkiláažoži, ðaažóži
slap (noun)	įcé bráaska, įcé bráze
slave	mą́ąhpiiži
slay	cˀéðe
sleep (noun)	žą́ą
sleep (verb)	žą́ą, žį́įhe
sleep: lie down to ~	žą́ą
sleep-matter-in-eyes	įcóolą
sleep over (stay all night)	žą́ą
sleep sitting up	lįlį́įe, žą́kxa žįhé
sleepy: be ~	įįštáha cˀóka
sleepy-in-eyes	įcóolą
sleet	ną́ɣežį, niižúpa
sleigh	žą́ą ákaastowe
slender	lažį́į
slice (verb)	kaascú
slice by using a sharp edge	pascé
slice meat (as for a barbecue)	wakái
sliced (adjective)	žáhta
slick	štáha
slide (intransitive)	mašcúce, ostá
slightly	ékǫ
slim	bréhka, lažį́į, saakížįka, wahóšce
slip (intransitive)	ostá
slip or slip away: let ~	ðikšį́ce
slippery	mąąštáha
slit (verb)	kaascú, pážahta
sloppy, slouchy	ɣǫ́ǫce
slow (adjective)	lúži, ókxąži, scúuce, wascúuce
slow: take or make it ~	lúžihkiðe
slow about catching up	ókxąži
slow down (intransitive)	lúžihkiðe
slower	lúži
slower: make ~, slow down	lúži káaɣe
slowly	lúži, wascúuce
slowpoke, slow person	ošcúuce
slumber (verb)	žį́įhe
sly, on the sly, be sly	nąlǫ́ǫha
small	wahókˀa, wahóšce, xóhtą, -žį, žįká
small: quite or very ~	wahóščažį
small amount	hépe, hépežį, huužį, oh́epe, wahókˀa
small amount of something	-žį
small amount of number	čóopa
small change (money)	ošpéžį
small items, pieces, or things	ošpéžį
small number of (e.g., people)	huužį
smaller: make ~	ðuuhépe
smart	waðíląhtąą
smear on	stáðe
smell (N and intr.)	brą́
smell (transitive)	ðibrą
smell: acrid or sour ~	zą́zi
smell: cause to ~, as in making cedar smoke for a cleansing or blessing	oðíbrą
smell: have an offensive ~	ɣoį́
smell bad	žą́ąže
smell (good or bad) from heating	táabrą
smell of something cooking (noun)	watáabrą
smell unpleasantly sour	žą́xta
smile (noun)	íizažį
smoke (noun)	šóce
smoke (intransitive)	waðáašoe
smoke (transitive)(e.g., tobacco)	ðaahtą́, ðaašóe
smoke (transitive), as in making cedar smoke for a cleansing or a blessing	oðíbrą
smoke: make a ~ (e.g., roll a cigarette)	nąnį́ǫpa káaɣe
smoky	šóce, xóce
smooth	stá, stáko
smooth and shiny (as a lake surface)	stáha
smooth by pressing (iron)	puštáha
smooth out	ðuustáko
smooth something (e.g., cloth with an iron)	wapúštaha
smoothed out (e.g., icing on a cake)	bráaða
smoothing: by ~	pu-
smother with smoke or dust	íkaskike
snake	wécˀa
snap in two	ðiixǫ́
sneak off	hkóopše
sneaky ~	nąlǫ́ǫha
sneeze (verb)	héchį
snicker (verb)	íixažį
snoop (v,n), snoopy	océštą
snore (verb)	lóce
snot	hpalį́
snotty	xtoe
snout	hpá
snow (noun)	pá, pá húðe
snow (verb)	pá húðe
snowball	pahúkaaski
snowfall	pá húðe
snowman	pánihkášie
so (therefore, that's why)	éetana, káakǫ tą
so! (an exclamation used especially in storytelling)	hą́ą
so very, so very much	wálį
soap	wépukxa
soap: dish ~	hį́įce íðuuža wépukxa
soar, as an eagle	káawįɣe
sober	ną́ąɣeska
sober up	ną́ąɣeskaahkiðe
socially distant from	ákahahta
society: secret ~	nǫ́hǫžį
socks	hį́įǫke, hį́įǫke xóe, hǫǫpé okáwiɣe
soda	niikáapxohke
sodden	špǫ́ǫ
sofa	ál̨įįscee
soft	štǫ́ka
soft drink	niikáapxokeoožú
soften, become soft, softened	špǫ́ǫ
soften by pushing on	paastǫ́ka
softly: touch ~ as with a feather fan	ðiihcé
soil (noun)	mą́įhka
soiled	wasúhuži
soldier	áhkita, áhkita ną́ąžį, wanáše
soldier dance	áhkitaną́ąžį waachí
sole (solitary)	ohką́ci
solely	na, ną́ški, wįįðé
solicit	waatá
solid	saaki
solitary	ohką́ci
solo dance by one who has been in a war	wašóše achí nąąžį́
some	hépe, tóa
some day, some days	hǫ́ǫpa wį
someone (whose name one doesn't remember)	tą́ąska
something	táatą
something (the name of which one doesn't remember)	tą́ąska
something scattered	ðéeke ci
sometime	hǫ́ǫpa wį
sometimes	ðéeke ci, hǫ́ǫpa wį
somewhat	ékǫ
son: baby ~ (used by a woman of her youngest son if there are at least two older sons)	kxáhpą
son: first or eldest	ilǫ́ǫhpa, ilǫ́ǫhtą
son: second	kšǫka
son: third (or subsequent son)	kxáke, kxážį
son (without reference to age)	
'my son'	wižį́ke
'your son'	ðižį̌ke
'his/her son'	ižį́ke
song	waaðǫ́
song: peyote ~(song sung in a peyote meeting)	hkihkǫ́ze waaðǫ́
songs: calling	wapą́ waaðǫ́
songs: sun	mį́į̌wáaðǫ́žį
son-in-law	
'my son in law'	wihtǫ́ce
'your son in law'	ðihtǫ́ce
'his/her son in law'	ihtǫ́ce
Sonny (nickname)	wižį́ke
soothing	štáke
sore (noun)	ðéskali
sorry: be ~(used to apologize)	ékǫ kǫ́ðaaži
sorry: feel ~for	áacexcį, ðakˀéðe
sorry: feel ~ for one's own or someone close	ðakˀékiðe
sort(e.g., beans, clothing to be laundered)	hpahíke, paahí
sort: what	táatą
soul	waðílą, waną́ąɣe
sound (noun)	ónie
sound: beating	hcíce
sound out	hóotá
sound: make animal ~(e.g., sing like a bird, moo, bark, howl)	hóohtą
soup	htaaníi
soup: drink	ðaazúpe
soup: preparation of dried corn	watxázu
soup kettle	htaaníe céɣe
sour (taste)	cˀáaðe
sour odor: have a	žąxta
south	mąąšcé kšíhtaha
south wind	ákˀahúe
souvenir: keep as a ~	kícheðe
sow (e.g., seed in the ground)	oožú
space (in the sense of an unoccupied area)	óhką
space between things	ohtą́ná
spade (e.g., as gardening tool)	mą́ąhįspe, mą́ąhįsu
spade (suit in a deck of cards)	hámąsi, mą́ąhiąspe, mą́ąhįsu
Spaniard, Spanish person	íšpaðǫ
Spanish (adjective)	íšpaðǫ
Spanish language	íšpaðǫ
Spanish-speaking: any native ~person (especially Mexican)	íšpaðǫ
spank	ochį́
spare (verb)	ošcé
spare someone's life	toníðe
sparks that are struck	kaalį́įže
speak, speak of	íe
speak clearly	íe ðáawaska, íeska, wáðaaska
speak ill of	ðaažóži
speak of oneself	ohkílaake
speak positively of negetively of someone	íkie
speak to each other using (a certain language or the hands)	íhkihkie
speak to one's own relative, family, or friends	okíhkie
speak the truth	wį́kše
speak truthfully	íe wáðohta
speaking: clear or clean	íe wasúhu
special	óxta
special: make ~, give ~ status to	óxtaðe, óxtakiðe
special things	wahćeka
speckled	léže
spectacles	mą́ze įįštóolą
spectators	watǫ́pe
speech, make a speech	íe
spell of illness or trouble of any kind	ókaše
spider	hcéxope
spin, spin around	wįɣe
spirit	ilǫ́ɣe, ną́ąɣe, waną́ąɣe
spirit: holy	waną́ąɣe
spirit land	waną́ąɣe mą́žą
spit, spit on ,spit out	ðaakˀį́
spittoon	íluekˀí
splash, splatter	paasíke
splendid	ðáalį
splice	wápaase
splinter (verb)	paasíke
splinter from sudden impact	kaaxúɣe
splinters	žą́ąxeži, žą́ąžį
split (adjective)	žáhta
split (verb), split open	kaaxúɣe
split lip	íhaa žą́ąže
spoon	hcéhapa, hcúke
spoon: wooden	žą́ąhcuke
spotted	léže
spray	paasíke
spread (intransitive)	paaɣáce
spread (transitive)	ðíbra,ðuuláwa
spread on (as shoe polish)	ápuštai
spread open	paaɣáce
spread out (e.g., a cloth)	ðíbra,ðuuláwa
spread over, spread upon	áðubra
spreader for Osage headdress	htaasį́įce wahú
spring (natural water spring)	níini
Spring River [LFD]	tóoskue káxa
springtime, spring	pée
sprinkle (light rain)	niižúžu
sprinkle (rain lightly)	nuužúžu
sprite	míalǫška
square dance (noun)	sį́ka hpaléze
squash (vegetable)	hpǫ́ɣe, watxą́
squash (vegetable): yellow climbing ~(now extinct)	hpǫ́ɣe áace žį
squashed	tóže
squat and rounded	čáahpa
squaw corn (i.e., fresh corn)	hápa wacˀéka
squirrel	sį́ka
squirrel hunting	sįkóce
squirt	paasíke
staff used at peyote meetings	mą́ą
staff with feathers	haawálele, waléle
stagger	šéšeka
stain [LFD]	ðóðo
stairs	ánaašile
stalk (noun)	hú
stammer	ðéeze opásike
stand, be standing	náážį́
stand on top of (used in comparisons)	ánąąžį
stand there (as in a room or place)	oną́ąžį́
stand up (preparatory to departing)	nąąžį́
standard (flaglike object)	haawálele
star	mihkákˀe
star: evening	mikhákˀe hą tą ðįkšé
star: falling	mikhákˀe oxpáðe
star: little	mikhákˀežįka
star: morning	mikhákˀe hą́ąpa tą ðįkše, mihkákˀe ką́ąpaska tą, mikhákˀehtąą
star: morning of male	wáhce tooka
star: orbit of a	mikhákˀe óžąke
stare (at people)	watǫ́ scee
start	šką́
start: unable to ~(as a motor vehicle)	šką́aži
start (e.g., a car motor)	ðuušką́
start off	aðée
start to, suddenly start to	ahí
startle someone	hóšechie
startle someone (as with suddenly emerging news)	pólǫðį
startled	pólǫðį
startled: be ~	hósechie
startled: be ~(as by a dream of nightmare)	ohpáza
startling, startling news or report	hóšechie
starving: be	nǫhpéhicˀe
starwort (Liatris puncatata)	mąhká saakí
statement: make a ~, state	oðáake
stationery with writing	waléze
stay	mąðí, wáaspe
stay all night	žą́ą
stay-at-home	wáaspe
stay quiet	wáaspe
stay there (as in a room or place)	oną́ąžį
stay there! (command)	šée mąðį́
stay there (wait)	šée nąąžį́
steak	htáa taazíhi
steal (intransitive), steal things	wamą́ąðǫ
steal (transitive)	mąąðǫ́
stealing	wamą́ąðǫ
steam (intransitive)	opˀą́ða
steam (noun)	íopˀąðą
steam rising off standing water	opˀą́ða
steer	hceeskatátooka
step on, step in	ánąąžį
steps (stairs)	ánaašile
sterile (childless)	wéetaðaži
stick (intransitive)	káataace
stick (noun)	žą́ą, žą́ąxe, žą́ąxežį
stick: burial ~(red stick put into coffin at head or foot, made of special wood)	hką́ące žą
stick: shinny ~(curved stick used to play kašini)	ohkíce
stick: small	žą́ąxežį
stick out	ðuhtáža
stick to	ásta
stick to drive people or animals, stick that the tail dancers carry	wékaaži
stick used to rub the fire-making wood	hį́įcecˀohu
stickers, stickery	waxáka
sticky	wáasta, wáðastátá
stiff, stiffened	sáta
still (as a lake)	škaškáða
still (not in movement)	ška ðįké, šką́aži
still (yet)	šǫ́
stingy: be ~	kíwalį, wáli, wáwalį
stingy person: be a ~	wáwalį
stink, it stinks! (an exclamation)	ɣoį́
stinking odor: have a ~	žą́ąže
stinky	ɣoí, žą́xta
stippled	léže
stir (e.g., food when cooking)	oðókahi
stockings	hį́įǫke
stomach	hcéze, šúpe, wánǫbréoožú
stomach: part of the ~ resembling little ooks or pages (used for soup)	otáhpa
stomp the ground	nąąstá
stone (noun)	íi
stoop over	paacˀó, paakˀó
stoop over (as to touch toes)	paacˀį́
stop (interjection)	kaaštą́
stop (intransitive)	ðiištą́, panáa
stop (transitive)	ðiištą́, kaašǫ́ káaɣe, nąąžį́le, panáa
stop! wait! (used to get someone to pause or suspend an activity)	katxą́
stop an activity	kaaštą́
stop an activity involving the mouth	ðaaštą́
stop in	ahí
stop someone/something	nąąžį́
stop something (make it end)	ðiištą́ káaɣe
stop something (make it halt)	oðiitą
stopped up	ocˀį́ze
store (commercial establishment)	watǫ́ehci, watǫ́ǫžu
storm with strong winds	htaacé hpíiži, htaacé óhesaži
story	híko, óðaake
stove	océðe
stove: heating or wood-burning ~ (for heat, not for cooking)	hpéece íiška
stove: metal ~	mą́zewéoohǫ
straight (even)	stáko
straight (virtuous)	óðohtą, wáðohtą
straight: make oneself ~	óðohtąhkiðe
straight: talk ~	íe wáðohta, íeska
straight up	óðohtą
straighten, straighten out, straighten up	ðuustáko
strange	éeži
stranger	hpáðįhǫka, ohkíhce
strangle	tóoce oðį́įke
strawberry	pąąšcéka
stream: small ~	káxa žį
street	ošą́ke ohtą́ną
strength	waašką́
strength: having ~	waašką́htąka
strength: lack ~	waašką́ðįké
stretch (transitive)	ðiizíðe
stretch oneself	hkilíiziðe
strike (e.g., a drum or a person)	ochį́
Strike Axe (name of a band)	mą́ąhįspe
strike with	iichį́
striking: flint for ~	kaalį́įže
strip something (e.g., husk corn or peel a banana)	ðuušáake
striped	léze
strong	saakí, sísi, waašką́htąka
strong: very ~	óhesaži
stronger	óhesaži
strong-willed	níhka wažį́htąą
stroud (cloth)	haažúuce
struggle (verb)	íkˀice, waašką́
stuck: get or be ~ to	ásta
study	íkˀuce
stuff (see calence reducer prefix)	
stuffed up	ocˀį́ze
stumble	xíða
stumble and fall	hípše
stumble repeatedly	xíxiða
stun	ðusáaki, kaapxóhke, káasaaki
stutter	ðéeze opásike
subject markers	akxa, apa
subpar: be ~	oolą́ąži
subscribe	žáže kikáaɣe
succeed (follow); successive	okínąąžį
succeed anyway	óðąži
success: achieve ~ for someone	ðaalį kšíðe
successful: be ~	ðáalį káaɣe
successful: be ~ anyway	óðąži
successful: make someone ~	ðáalį kšíðe
succession (e.g., of chiefs; also one of anything following another)	opxą́pxą́
suck	ðaašóe
sudden application of force or sudden movement: by ~	kaa-
suddenly start to	ahí
suffer from	ǫ́ǫ
suffer from an illness	kihúheka
suffer from heartache	ðą́ąceníe
suffering (adjective)	waxpáðį
sufficient	kaakǫ́ną
sufficient, it's sufficient	kaašǫ́ka
sugar	žąąníi
sugar bowl	žąąníioožu
suicide: commit	cˀéhkiðe
suitable	ðąąché
suitable: be ~	íhta
suitcase	wáseska
sulk	lǫ́ǫ, ólą
sulk about another's good fortune	óxįį
sulky	ólą
sullen	ókˀą hpíiži
summer: last~	tookéce
summit	ákaha
sun	mį́į
sun seen straight overhead (high noon)	mįįðóhta
sunbeam	mįįtáašcuuce
Sunday	hą́ąpa wahkǫtáki, hą́ąpa wahkǫ́táki,
sundown	mį́įhiðe
sundown: toward ~ (as a a time of day)	mįįáðee ehtáha
sunflower	mį́įhtǫeli
sunglasses	mą́ze įįštóolą sápe
sunrise	mį́į íðǫpe
sunset	mį́įhiðe
superintendent, as of the Osage Agency	mą́ąhį htą́ą
superior: be ~ to in some quality (used in comparisons)	ánąąžį
supervise	oðóðe
supervise someone specifically in response to a formal request (e.g., taking care of the food for an event)	okášą
supervisor	oðówaðe, wakáaɣe
supper (evening meal only)	hpáze wanǫ́bre
supper (noon or evening meal)	wanǫ́bre
supply	okˀú
supply to folks	ókˀu
suppose: I ~ that	ska
surface	háa
surgery	hpáce
surprise: interjection expressing ~ (said to be a woman's exclamation)	íto
surround	ákiɣe, oðíši
surroundings: in the ~ of	ákahahta
surveillance: have under ~	nąlǫ́ǫha átǫpe
suus prefix [SUU]	kik-
swallow (verb)	ðaašcúe
swallow: a ~ or two (of a liquid)	huužį
swan	míɣa ska
swap (noun)	íhkihkawį
sweat	į́į olį́į, paɣice
sweat lodge, sweat house	ítaasuhu, į́įolįįhci
sweep (transitive)	kaacúxe
sweet (noun)	waskúe
sweet food or sauce	skúðe, waskúe
sweet milk	paazénii skúðe
sweet potato	tooscée, tóoskue, tóožuuce
sweet potato branch (Sweet Potato Creek)	tóoskue káxa
sweetheart	ðą́ące skúðe
sweets	waskúe
swim	hiiðá
swim: place to ~	ohíiða
swim supporting a child in the water	ðuškápa
swindle	mąɣíðe
switch off	ðuutáaži
sycamore	waséhtąhú
table	áwanǫbre
tablecloth	áwanǫbre aðibra
table hop (verb)	ákiɣe
taboo	wáalake (?)
tall (animal's tail or part of Osage dance costume), tail dancer	sį́įce
tail feathers: fan made out of ~	íhkuáci
take (select, take out)	ðuuzé
take (take along, carry)	kˀį́ahi
take a bath	hiiðá
take a seat	olį́į
take a wife	mį́įląke
take a husband	áðuɣe
take each other as relatives	ðótahkiðe
take as a sexual partner	ðúɣe
take as a wife	lą́ke
take away	aðj́aðee, aðį́mąðį, ðicíze
take away from someone something of his/her own	kilúuze
take away one's own	lúuze
take back (motion underway)	aðį́alee
take back there (motion accomplished)	aðį́akši
take care of	áhkihtǫpe, ákihtǫpe, ákitǫpe, átǫpe, ðakˀéðe, okášą, okáše, wanáše
take care of a meal oneself when asked to do so	óohkihą
take care of a task or an event	oðówaðe
take care of kids or children	žįkókašą
take care of oneself	óhkihkaše
Take Care of the Eagle (personal name)	xuðókašą
take charge of	ókašą
take clothes off (another person or oneself)	ðuušáwa
take down	ðuuhúuce, ðuxpáwį
take each other as relatives	ðótahkiðe
take hold of	oðį́įke
take hold of one another	mą́hki
take home (motion accomplished)	aðį́akši
take home (motion underway)	aðį́alee
take home for oneself, take home as one's own	ahkílįalée
take it slow	lúžihkiðe
take off a garment	ðiištówe
take off a person's clothes (e.g., a child's clothing before a bath)	ðuušáwį
take off by pulling	ðiištówe
take one's own	aláðį, aláðįðee, lúuze
take out something by removing, extracting, or lowering it	oðúuxpaðe
take sides with respect to someone	íkie
take someone's side	áhkie
take there (motion accomplished)	aðį́ahi
take there (motion underway)	aðį́aðee
take up for someone	áhkie
talk, talk about	íe
talk: clean or clear ~	íe wasúhu
talk about something positively or negatively	óie
talk clearly	íeska
talk for another, talk in the presence of others	ékie
talk for or against someone	áhkie, íkie
talk in one's sleep	žą́ą tái įké
talk someone silly	páalǫðį
talk straight	íe wáðohta
talk to each other using (a certain language or the hands)	íhkihkie
talk too long	íe scece
talk too much	óochiže
talk up or talk down, as when expressing one's emotions with respect to some topic	áhkie
talk with one another	ohkíhkie
talkative in excess	óochiže
talker (person who talks too much)	íe scece, íeštą
tall	húuscee, scéce
taller	húuscee
tallow	wélisaaki
tamales	wacúexǫ oðiši
tame (adjective)	wacˀéka
tame (verb) (e.g., a horse)	ðiwáštake
tangled	hkíhkįnį
tangled: get oneself ~ in	ohkíǫðe
tape (make a recording with an audio device)	íe ðuuzé
tape recorder, tape player	mą́zeie
tapping noise against metal (as made by a typewriter)	mą́ze htáhtaze
tapping sound	htáhtaze
tarantula	hcéxopehuuscee
task	ówǫ
taste (verb)	íkˀuce
tea	hpéže mą́hka
tea: buckeye ~	htáška hí
tea: cedar ~	xǫǫcénii
tea: green ~	hpéže htóho
tea: iced ~	hpéženii ną́ɣe oolą́
tea: peyote ~	wanǫ́brenii
teach	wakǫ́ze
teach something to someone	kǫ́ze, kšiǫze
teacher	wakǫ́ze
teachings	íe
tear (noun), teardrop	įįštábri
tear (verb)(rip)	kaabráze
tear apart (e.g., a tree limb from the trunk)	ðupáxa
tease: be a ~,tease someone	ðiihíce
tease people	waðíihice
teenager	hcéka nǫ́ǫ
teeter	sísiąðe
teeth	híi
telegraph	mą́zekˀąsaaki
telegraph: send there by ~	mą́zekˀąsaaki ðée káaɣe
telephone	mą́zeohkíhkie
television	mą́ze íe ówatǫe
tell (e.g., news, stories)	oðáake
tell about oneself	ohkílaake
tell someone not to (do something)	ížoši
tell someone to do something	ée, hce ée
tell the truth	wį́kše
tell untruths	íxope
tell-all	táatąžį́ śki óðaake
telling: a ~ of something	óðaake
temper: bad ~	waðílą hpíiži
tempest	htaacé hpíiži, htaacé óhesaži
ten, tenth	lébrą
ten cents	waðáawa lébrą
tend (take care of)	átǫpe
tend someone	átkitǫpe
tender	wacˀéka
tent	haaskáhci, wažáihci
tepid	štáke
terminate an activity preparatory to departing	nąąžį́
terrapin	hkée
test (verb)	íkˀuce
test: put each other to a ~	áhkiasąci
test: put someone to the ~	ásac̨i, kasǫ́ci
testicles	šǫcóso
testimony: give ~	wawépahǫ
text: document or paper containing ~	waléze
thank you	wéewiną
thank you ('feel good' used as an equivalent of thank you)	kiðálį
thankful	óweena
thankful: be ~ (for)	wéeną
Thanksgiving Day	súhkahtąą hą́ąpa
that (complementizer connecting subordinate clause to the following main clause)	che
that, this, those, these	ðée
that, those (near you)	šée
that, those (person[s] or thing[s] that are relatively remote or whose exact description is unknown or of little importance)	tówa
that direction	émąhta
that one, that person (emphatic pronoun)	ée
that only	éená
that way	kaakǫ́
that way: along ~	ée htáha
that yonder	kóota
that's all	kaakǫną́
that's why	eená
the (no exact Osage equivalent; see positional articles; subject markers; that; this)	
theater	ówatǫįhci
theater presentation	ówatoį
theft	wamą́ąðǫ
their, theirs	íhta, íhtaapi
their place: at ~	ecí pa
them (There is no direct equivalent in Osage)	
themselves (see reflexive prefix)	
then, and then immediately or right away	kaðǫ́
then: and ~	kaðǫ́, káakǫ tą
there	ðeeká
there: be ~	ecí
there: get, stand, or stay ~ (as in a room or a place 0	oną́ąžį
there: go, come, or arrive ~ (motion accomplished)	ahí
there: go ~ (motion underway)	aðée
there: over ~	ée htáha, kaaðó, kootáįke
there (near you)	šé, šeeðǫ́
therefore	ðekáhtą, eená, éetana, ékǫ, étą, káakǫ tą
these	ðee, ðeeká
these, this (animate or inanimate, emphatic or expressing certainty or immediacy)	káa
these scattered	ðéeke
they (There is no direct equivalent in Osage).	
they too	eeškit́ą
thick	šooká
thick skin	háa šooká
thief	wamą́ąðǫštą
thievery	wamą́ąðo
thigh	sízo
thin	bréhka, lažį́į
thing	tą́ąska
thingamajig	tą́ąska
thing(s)	táatą
things: many or lots of ~	táatą ochí
things: small ~	táatąžį́
things one has to do	ówǫ
things scattered around (as in a messy house)	ópoce
think	waðilą
think about	éðe, ékiðe, íðilą, óðąąceši, waðilą
think about again	oðóhake íðilą
think about something	táatą íðilą
think ill of someone	hpíiži ažį́
think on	waðilą
think oneself to be a certain way (?)	áhkiži
think regarding someone	ažį́
think so	ékiðe
thinking	waðilą
third	wéðaabrį
thirsty: be ~ for	ípuze
thirteen, thirteenth	lébrą álįį ðáabrį
this	ðée, ée, káa
this time	ðétxą
thorns, thorny	waxáka
thorny tree	žą́ą waxáka
thoroughfare	óžąke
those, that	ðée
those, that (near you)	šée
those, that (person[s] or thing[s] that are relatively remote or whose exact description is unknown or of little importance)	tówa
those from around here	ðeekíha
thought	waðílą
thoughtlessly	iðílą ðįké
thousand	žą́ąhkoke
thrash	ochį́
thread	háaweáze
three	ðáabrį
threshold	hcižépe
throat	tóoce
throat: sore ~	tóoce níe
through (direction).	ha
through: be ~ (be finished).	ðiištą́
through: go ~ (as a road).	opxą́
through the action of.	í-
throughout: be ~ an area or a group of people.	omą́ðį
throughout: be ~ a person's body.	omą́ðį
throw.	kį́įðe,ǫ́ǫða
throw away.	ǫ́ǫða,ǫ́ǫðe
throw each other away.	hkíǫðe,ohkíǫðe
throw off (suddenly severing or moving something or someone from something).	okáxpa
throw oneself into.	ohkíǫðe
throw someone away.	ohkíǫðe
throw up due to overheating.	ókohpa
thumbprint: make a ~ on a document in lieu of a signature	íkuspe
thumb hard	taašéðe
thumping sound (e.g. footsteps).	heíce
thunder (noun).	lǫǫhǫ́,lǫǫhóohtą
thunder (verb).	lǫǫhóohtą
Thunder clan, person of the Thunder clan.	lǫ́ǫ iníhkašika
thunder people.	lǫ́ǫ níhkašika
thunder: grandmother~.	iihkó lǫ́ǫ
thunder: lots or large amount of~.	lǫǫ húu
Thursday.	hą́ąpa wétoopa
thus.	éetana,ékǫ
thus with certainty.	kaakǫ́
tick (e.g., a clock or an insect making noise)	htáhtaze
ticking noise against metal (a made by a typewriter)	mą́ze htáhtaze
ticking sound	htáhtaze
tickle	ðikˀíðe
tidy, tidy up.	ðuustáko
tie (e.g. shoelaces).	oðáške, okáške
tie down (e.g. a drum).	paaxcé
tie in a bundle something specific, tie stuff up as a bundle.	opétxą
tie the drum; (involves wrapping the drup ip and tying it).	céɣenii káaɣe
tie to something	ákaške
tie up.	ákaške,ápetxa,ðuušáwį,kašké,oðíiną,okáške
tight,tightly.	saakí
tight (inebriated).	lǫ́ðį,omą́įžį
timbers.	zą́ą
time: a long ~ (which has passed).	káaši
time: at this ~.	ðetxą́ci
time: be at that ~.	ecí
time: from this ~ on.	ðetxą́ha
time: in or near that ~.	ée htáha
time: it is ~.	éetxą, mįįðóhta
time: it's ~ again.	ékitxą
time: this ~.	ðétxą
time after time.	ohkíetxątxą, ótxątxą
time of day (as told by the clock).	mį́įoðaake
tinder.	žąąhcúkˀa
tiny.	wahóščažį
tip (of an object).	hpasú, ihtáɣe
tipi.	wažáihci
tire (of a vehicle).	hcéðe
tired.	kaaskíke, skíke
tired: be ~ of.	íibrą
tired: become or be ~ of.	oðúucˀake
tired: feel ~.	óžeðe
to.	ci, įkši, ki, kši
toad.	níižu oxáke
toad: horned ~.	kalǫ́eže
tobacco.	nąnúhu
tobacco bag.	nąnįǫ́kužu, nąnúhuoožúhaa
tobacco boss (whos sits to the left of the roadman in a peyote meeting).	nąnįǫ́pa olį́į
tobacco pouch.	nąnįǫ́kužu
today.	hą́ąpa, hǫ́ǫpa ðé
toe.	siihpó
together: place ~ (as when cooking two or more items together).	oðóhkiðe
toilet, toilet room.	ožehci
toilet paper.	íkahci
told: as it is or was ~ (e.g. as in a story or in the Bible). (see reportive markers)	
tomato.	hką́ąðe žúe
tomorrow.	kaasj̨́
tongue.	ðéeze
tongue-tied: be ~, tongue splayed or split.	ðéeze opásike
tonight.	hąąðé
Tonkawa (tribe or tribal member).	waðánii
too (also)	ški,-škítą
too (excessively).	wálį
too: he/she, it, or they ~.	eeškítą
too much or too long: person who talks ~.	íe scece, íeštą
tool.	wéhkikˀǫ
tool for cutting wood.	wépaase
tool used to make something	wékaaɣe
tooth.	híi
toothless.	híi jke
top, on top.	ákaha
top: on ~ of s.t	else ámąši
topple (as a tree topples)	xíða
torn	bráze
torn (said of clothing)	cúuða
tornado	htaacé hpíiži, htaacé óhesaži
tortoise	hkée
toss	ǫ́ǫða, ǫ́oðe
totter	sísiąðe
touch softly as with a feather fan, barely touch	ðiihcé
touch the of s.o	šáake oðį́įke
touch with the fingers	paaspą́
touch with the hand	ðiihtą́
toward	hta, htáha
toward: not ~ that way	émąhtažíha
toward the center	mąchéhtaha
toward you: go ~	šoðée
toward you (along a path toward where you [the hearer] are or toward something or someone nearer to you than to the speaker)	šée htaha
towel: hand ~	šáake ípukxa
towel: dish ~	hį́įce ípukxa
towel: paper ~	htaną́kˀa ípukxa
town	htą́wą
Town Builder (personal name)	htą́wakáaɣe
town crier	íekie, wacípxaį
toy with	ðiihíce
tracks	šáake
trade (noun)	íhkihkawį
trade (verb)	íhkihkawį káaɣe
trade for	íðuwį
trading house	watǫ́ǫžu
traditiong	óðaake
tradition: embrace as ~	oðį́įke
trailer	oðíhtą hcí oðáha
train	oðíhtą kˀą́saaki
trample	nąąstá
tranquil	škaškáða
transport (verb)	kˀį́ahi
trap (noun)	mą́ze oðóbrįįke
trash (noun)	ópoce
travel	kaalǫ́ðe, wamą́ðį
travel around	opáwįɣe
travel on (e.g., certain funds)	iiðée
traverse (e.g., a streer)	áðuuhta ðée
Treadway: George ~ (nickname: Stattered Forehead)	hpéeleke
treasure	wahcéka
treasure: keep as a ~	kícheðe
treasure one's own	kíoxta
treasure s.t	kíwalį
treasured: someone or something ~ (such as a favorite child)	óðoxta
treat others (medically)	wašcéðe
tree	žą́ą
tree: thorny ~	žą́ą waxáka
tree branch, tree branching out	žą́ą káxa
Tree-killer	[LFD] kaalį
trees growing in a nonrandom pattern.	žą́ą pe
tremble.	ðibrúbruɣe
trench (noun).	ną́ceaha
trench (verb).	náce káaɣe
trial.	áhkiisto
tribal council session.	hkiistó
tribe: western ~ or tribal member (refers to any tribe from the western United States).	hpáðį
tribe other than Osage (including western tribes).	ohkíhce
trick (verb).	mąɣíðe
trick them.	wáðihota
trigger.	mį́cehką
tripe.	hceeníxaxa
trouble: be in ~ for doing something wrong.	ohkíǫðe
trouble: have health ~ with.	íhuheka
trouble: make ~ for someone	ówǫ káaɣe
trouble someone	ðišǫ́ži, ówǫ káaɣe
troubled: be ~ by problem or sickness.	ókaše
troubled: be very ~ by (e.g., an illness, an ailing body part).	íhpiiži
trousers.	oðíkinąąžį
true.	wį́kše
true!	ékǫ
true: be ~ to.	wį́kše
true: be ~ to one's own.	okípše
true: be ~ to oneself.	wį́hkikše
trunk (box).	žą́ąhkoke
trunk (e.g., of a tree).	hú
trust oneself: not ~.	hkíxiða
truth.	wį́kše
truth: speak or tell the ~.	wį́kše
truthful.	wawį́kše
truthfully.	wáðohtą
truthfully: speak ~.	íe wáðohta
try (verb), try on.	íkˀuce
try hard, try one's best.	íkˀuce, waašká
tuberculosis.	mą́ąke ní, mą́ąke púze
tuberculosis.	hóxpe hpíiži (?), hóxpe zúpe (?)
Tuesday.	hą́ąpa wéðǫǫpa
tug (verb).	ðiitą́
tug something over in order to cover something or someone	áðuzu
Tulsa (Oklahoma).	htaasíkee htáwą, túlsa htáąwą
turbulence.	óochiže
turkey.	súhkahtąą
turkey buzzar.	héka
turkey cock.	áaju mą́ðį
turkey feather.	súhkahtąą mǫ́šǫ
turkey hen.	súhkahtąą mį́įka
turn (root.)	hkóįɣe, -wįɣe
turn (transitive)	ðiisą́ða
turn: be one's	waðíhta
turn: it is my ~	wíe
turn: whose	pée
turn: your	ðíe
turn around (root.)	hkóįɣe, -wįɣe
turn in the road	ípaašąha
turn off	ðiistą́, ðuutáaži
turn on	kaáɣe
turn one's own	liisą́ða
turn oneself around	ámąhta hkilíikoįɣe, hkilíisą
turn over (transitive)	ðiisą́ða, ípasą
turn over and over (transitive)	ðusą́sąwį
turn over one's own	liisą́ða
turn s.o or s.t around	ðiihkóįɣe
turn up	ðumáða
turn wrong side out	ðuháašɣðe
turnaround place	ípaašąha
turnip	tóolehtąą
turnover bread	wacúe žéela
turtle	hkée
twelve, twelfth	lébrą álįį ðǫǫpá
twenty, twentieth	lébrą ðǫǫpá
twenty-one, twenty-first	lébrą álįį ðǫǫpá wį́xci
25-cent piece	kašpéðpa
twice	ðǫǫpá
twings of a tree or bush: small	žąąžį, žą́ąxežį
twin (N.)	ðǫǫpátą
twist, twist around (e.g., a crepe paper streamer).	ðusą́sąwį
two	ðǫǫpá
two of them, couple, pair	nahkǫį́
type: what	táatą
typewriter	mą́ze htáhtaze
udder	paazé
ugly	ohtázaži
ulutate	ðaazó, waðáazo
umbrella	oðínii
unable	ðąącháži
unable: be ~ to do	ðuucˀáke
unable: be ~ to understand	hahkíe, kíopxaži
unable: items one was ~ to eat	ðaacˀ́áke
unable to move or start (as a motor vehicle)	šką́aži
unafraid	nǫ́ǫhpaži
unafraid of	íinǫ́ǫhpaži
uncle (specifically, brother of father)	
my father's brother	įhtáci, įhtácižį
your father's brother	ðiðáce, ðiðácežį
his/her father's brother	iðáce, iðácežį
uncle (specifically, brother of mother)	
my mother's brother	wįcéki
your mother's brother	ðįcéki
his/her mother's brother	įcéki
uncle (specifically, husband of sister of father)	
my father's sister's husband	wíhtą́ha
your father's sister's husband	ðihtą́ha
his/her father's sister's husband	ihtą́ha
unclean (dirty)	wasúhuži
unclean (sick, evil)	ízizike
unconcerned with: be ~	óðąąceši ðįké
uncooked, undercooked	cúutaži
uncover partially	opéni
under, underneath	mąché, mąchéhta, oðúluha
under the head	į́pehi
undergarment (for men or women)	mą́che, oðúxa
undersign	žáže kikáaɣe
understand	íiðe, ípahǫ, kíopxa, nąkˀǫ́
understand: be unable to ~	hahkíe, kíopxaži
understand: not ~	kíopxaži, pxáðaži
understand things	wáopxa
understanding: act of ~	nąąɣúce
undertake, undertake a new task under one's charge	okášą
underwear	mą́che oðúxa, oðíkinąąžį
undivided	bróka
undress	ðiištówe
undress (another person or oneself)	ðuušáwa
undress oneself, get undressed	hkilíiša, hkilúušawa, hkilúuštake
undress s.o	ðuušawį, ðuuštáke
uneaten item	ðaacˀáke
unfaithful	wawį́kšaži
unfavorable impression made upon another by offensive conduct	wáalake
unfitting	ékǫži
unhappy	kízoži
unhappy: be ~	kihǫ́ǫži
uniform (even)	stáko
uninterruptedly	šǫǫšǫ́we
unique	éžixci
unique thing: that ~, uniquely so	wįįðé
universe	mą́žą záani
universe, all the universe	níǫhta záani
unkempt	ɣǫ́ǫce, héxpa
unlikely	ée htáhaži
unload (remove)	ðoxpáwį, oðúuxpaðe
unmarried female	wáðuɣaži
unmarried person	kažą́si [JOD]
unobserved: be ~ (as a custom)	óðąąceši ðįké
unpredictable behavior: show ~	taeðáalįži
unreasonable, unreasonably	ée htáhaži
unreliable	óškika
unripe	cúutaži
unruly	ókˀą hpíiži, waðílą eekǫ́ įké
unruly: be ~	taeðáalįži
unseemly	ékǫži
unskilled: be ~ (at)	kǫ́žįka
unsound	eekǫ́ ðįké
unstable: mentally ~	cˀéka
unsuitable	éeži, ékǫži. ihtaháaži
unsuitably	ée htáhaži, ekǫ́į́ke, íhtaháaži
unsuitably: act ~	ókˀą éži
unsure: be ~ (of something)	hahkíe
untamed	óhesaži
untamed horse	hkáwa wahcéxi
untie (e.g. horse)	ðuuškáke
until	txą́ha
untroubled	ókašéįke
untruth	íxope
untruthful	wawį́kšaži
untruths: tell ~	íxope
unusual	éeži
unwell: be ~	íhpiiži
unwilling: be ~ to	iiną́hiži
up	ámąši
up: get ~ (from a bed or chair)	hpaahą́
up: hold or pull ~	ðuumą́ši
up: hold or raise ~	opáahą, paahą́
up: raise or turn ~	ðumáða
up: take ~ for someone	áhkie
up: wake or get ~	hpaahą́
up: above, in the upper part	ámąši
upon	á-
upon: place ~ (e.g., a suitcase on a table)	álįį
upon: put ~	ákaaspe
upon (used in numbers)	álįį
upright: be ~	mą́ši
upright: place an item ~ on another item	ále
upset: make s.o or push s.o to be ~	páalǫðį
upstairs	ámą́ši
upward: be ~	mą́ši
urinal	océže
urinate	céže, hkilúuhepe
urine	céženii
us	ąkóta
use a name for something or or someone	ðaacé
use someone's	ootá
use to bless oneself	íistahkiðe
used to (do, be)	ną [iterative], nąpe
using: go by ~	iið́ée
using (by means of)	í-
useless	ókaaɣeįke
usually	ną [iterative], nąpe
utensils: cooking ~	wéoohǫ́, wióohǫ
U-turn	ípaašąha
vacant space	óhką
vagina	úže
vague: be ~ about	kíopxaži
valence reducer prefix [val]	wa-
valuable	óxta
valuable things	wahcéka
value: something of no ~	mą́ąhpiiži
value: something	kíwalį
valued: someone or something ~ (such as a favorite child)	óðoxta
valueless	ókaaɣeįke
vanish	ðįké
vapor rising off standing water	opˀąða
vegetables	ówe, wasúutą
vein (blood vessel)	hką́, lušúpe
venerate	óxta káaɣe
venereal disease	wácinie
Verdigris River	waséhtą xóe
vermin	walúška
very	wálį, xci, žį, óožu
vest (noun)	ákahahpa, wéhkilį
vile	iiséwaðe
vine	žą́ą áace
vine: bean ~	hǫbrį́ hi
vinegar	níi cˀáaðe
viper	wécˀa
virgin (noun)	wáðuɣaži
Virgin Mary	ižį́ke iihǫ́, wahkǫ́ta ižį́ke iihǫ́
virtuos	óðohtą
vision (sight)	wawéeðe
visit (noun)	wéehkile
visit a relative or one's own (family)	íkihtǫpe
visit to ask or summon someone to attend or appear before others	kípą
visiting, on a visit	íihkiðemąðį
voice	hóo
vomit	lépe
vomit due to overeating	ókohpa
vote, vote for	mą́šą oðįįke
vote, vote for or against someone or something	páaleze
wad together with a sudden movement	kaaskí
wad up	ðibrúuska, ðiiskíke
wad up, wad together (e.g., clothing at the back of the neck)	ðiiskí
wade	žópše
wager (noun)	óžokˀa
wagon	oðíhtą
wail	ɣaaké
waist	ðúwe
wait	šée nąąžį́
wait, wait for	iðáhpe
wait for folks	wéðahpe
wait for one's own family or close persons	iðákihpe
waiter, waitress	óohǫ owáwakˀu
wake (transitive)	ðixí
wake by foot	nąąxí
wake up, wake (intransitive)	hpaahą́, iihkíðe, -xi
walk	mąðį́
walk: go for a ~	mąðį́ aðée
walk among folks	ómąðį
walk around	ákiɣe, ápše
walk fast	htą́ąðį
walk in	omą́ðį
walk on or upon	ámąðį
Walker: Josephine ~ (personal name)	wažáxį
walking: go ~	mąðį́ aðée
walking stick	íisa
Walks among the Cedars (personal name)	xǫ́ǫce mą́į
wallet	mą́zeskaoožú
walnut, black walnut	htákue
wander	opáwįɣe
want	íðilą, kǫ́ða
want: make folks/one ~ to	kǫ́ðawaðe
want as one's own, want for oneself	hkihkǫ́ða
want something that is another's	kíkǫða
war (noun)	taaké totą́
war: go to ~	taaké, taaké omą́ðį
war dances of the Osages	ilǫ́ǫška
warm (adjective and intransitive)	šcúuce, táahkace, taašcúe
warm (transitive)	táašcue káaɣe
warm oneself, as at a stove or fire	táašcuehkíðe
warpath	totą́
wary: be ~ of	íinǫǫhpe
wash (e.g. clothes, hair)	ðiiškí
wash (e.g. dishes, parts of the body, food items, a car)	ðuužá
wash clothes, wash stuff	waðíiški
wash clothes for oneself	hkilíiški
wash one's own (body parts or possessions)	lúuža
wash one's own (e.g. clothing or hair)	líiški
wash oneself with	íhkiluuža
wasp	mąąpíaza, wapázike
watch (verb)	tǫ́pe
watch (some entity or some process)	átǫpe
watch one's own things	kihtǫ́pe
watch out for	íinǫǫhpe
watch over (one's own things or people)	ákihtǫpe
watch over (some entity or some process)	átǫpe
watch over each other	áhkihtǫpe
watch over oneself, watch over one's own things	áhkihtǫpe
watch people or events	watǫ́pe
water	níi
water: flooding ~	níita
water moccasin	níi wécˀa
watermelon	sáhku
water-strider bug	ámąðį, niiámąðį
way: be in the ~	iðǫ́eðįhé
way: be in the ~ while moving	oðóšimąðį
way: by ~ of	ha
way: in the ~	oðóši, wíohkaðį
way: on the ~ to a certain point	htáha
way: other ~	ámąhta
way: that ~	émąhta, šeeðǫ́ha
way: the other ~	ámąhtaha, ímąhtaha
way: this ~	ðeekáha
way: this particular ~	wįįðé
way over there, way back in time or distance	kootáįke
ways	ókˀą
wayward	eekǫ́ ðíké, íinǫǫhpaži, nǫhǫ, waðílą, eekǫ́ įké
w.c. (toilet)	ožéhci
we	ąkóta
weak	wahéhe
wear	áǫ, į́, oną́ąžį, ǫ́ǫ
wear: have someone ~	įkšiðe
wear around the neck	nǫpˀį́
wear on the head	oolą́ke
wear one's own	álaha
Wearing Bright Colors (personal name)	hį́įhkiąpi
weary	óžeðe
weary: become or be ~ of something	oðúucˀake
weather	mą́ąɣe
weather: warm, hot, or sunny weather	mąąšcé
wedding	wéðuɣe
wedding (term used by a friend or family of the bride)	wáðuɣe
wedding (term used by a friend or family of the groom)	mį́įląke
wedding hat: Osage ~ (a top hat with plumes optionally worn by the bride)	lǫǫhúu
Wednesday	hą́ąpa wéðaabrį
weed	hpéže
week	hą́ąpa wahkǫtáki
weep	ɣaaké
weighted down	skíke
well (adjective)	ókašéįke sísi, tąhé
well (adverb)	ðáalį
well (interjection)	ehtą́, ną
well (interjection) (often precedes a statement or command)	há
well (of water)	níini
well: be ~	ní
well: doing ~	sísi
well: get ~	kiní, kítąhe, ónihkie
west	mįįáðee ehtáha
west wind	mǫ́ǫhahtáhu
western tribe or tribal member (refers to any tribe from the western United States)	hpáðį
wet	toohká
whachamacallit	tą́ąska
what	haakǫ́
what (interrogative), whatever	táatą
what: do ~ for	háažǫ
what for? (as a one word question)	táatą
what if, what would you think if	ną́htą
what kind	hǫ́ǫxcį, táatą
what pathway: by ~	howaįkíha
what sort, type, or class of	táatą
what time	mį́įoðaake háaną
what time in the future: at ~	haatxą́ta
what time in the past: at ~	haatxą́ci
what-do-you-call-it	tą́ąska
whatever	haakǫ́, táatą, táatą howachéeški
whatever (thing)	howachéeški
what's his/her name	tą́ąska
wheat, wheat field, wheat crop	wapóške ówe
wheel	hcelį́
wheel: automobile ~	hcéðe
wheelchair	álįįhceðe
when (adverb)	éetxą
when (conjunction)	ðáha, pátą, šǫ́, tą
when in the future	haatxą́ta
when in the past	haatxą́ci
whenever	áha
where, wherein, where at, where to, be where	howáįki
where: through ~	howaįkíha
wherever	háaški
wherever, be wherever	howáįki
whereupon	áha, káakǫ tą
which	ímą
which, which one	hówa
which one: exactly ~	hówaxcį
which way (manner)	haakǫ́
which way (path)	howaįkíha
whichever one (inanimate)	howachéeški
while	sǫ́
while, for a while, after a while, a little while	katxą́
whip, horse whip	wékaaži
whip strongly	ochį́
whipman, whip	wanáše
whirl	-wįɣe
Whirlwind (name of a character in an Osage fable)	htaacéžį
whiskers	hį́į, į́hį aok
whistle	opíɣą
white	ská
white hair (of the head)	hpahį́įska
white man's language	įįštáxį íe
White Mountain (personal name)	paaxóska
white person (Caucasian)	įįštáxį, mą́ąhį htą́ą, xuháaska
whiten	skákaaɣe
whizzing sound	htáhtaze
who, whom	pée
who all	pée háaną
whoever	howaðéeški
whole	bróka, záani
wholesale	bróka
whoop (noun) (applies only to the noise women make)	oðáaze
whoop (verb)	ðaazó, hóosaaki
whooping cough	hóxpe hpíiži, hóxpe zúpe
whose	pée íhta
who's-it	tą́ąska
why	háakǫta
why: that is ~	éetana
Wichita (tribe or tribal member)	wícihta
wicked	hpíiži, hǫ́ǫži
wide	lą́ąðe
wide and smooth, as a prarie	bráaða
widower	wakˀó ðįké
wife	
my wife	wakˀó (wíhta)
wife (if the couple's oldest child is a boy)	wižį́ke iihǫ́, son's name + iihǫ́
wife (if their oldest child is a girl)	wižǫ́ke iihǫ́
wife (if there are no children)	wihtą́ke
your wife	ðiwákˀo, wakˀó ðíhta
his wife	iwákˀo
my/your/his wife	ilǫ́ǫhpa iihǫ́
wife	wakˀó
wife: take a ~	mį́įląke
wife stealer	wakˀó mąąðǫ́štą
wife: take as a ~	lą́ke
wild horse	hkáwa wahcéxi
wildcat	ilǫ́ǫka
will (mind)	wažį́
willing: be ~ (to)	iiną́hi
willow	mǫ́ǫsi céɣe
win (intransitive)	íiðį, óhi
win (transitive)	ohí
win over someone in a race	káaxa
wind	htaacé
wind instrument	opíɣą
wind: break ~	ðiipíɣą
wind: get ~ of	opéni
wind: strong or violent ~	htaacé saakí
window shade	akáaspe, okáhąpa akáspe
window, window glass	okáhąpa
windstorm	htaacé hphíiži, htaacé óhesaži, htaacé saakí
windy: be ~	htaacé saakí
wing	áahu
wink (at)	iištáðe ðiitóže
wink at each other	iištáðe ahkíliitože
Winnebago (Hochunk) (tribe or tribal member)	hóhtąka
Winnebago (Hochunk) language	hóhtąka íe
winner: be the ~	óhi
winner: habitual ~ (one who wins constantly or repeatedly)	óhištą
winnings	okšéhtą
winter	paðé
wipe (any surface)	kaací
wipe clean (after using the toilet)	kaací
wipe off	púkxa
wipe one's hands	šáake ípukxa
wipe to clearn or remove dust	púkxa
wipe with	ípukxa
wire	mą́ze
wire brush	wákaapše
wire: send by ~	mą́zekˀąsaaki ðée káaɣe
wire: telegraph	mą́zekˀąsaaki
wise	waðílą ochǐ
wish (transitive)	íðilą
with	í-, žóle
with: be ~ each other	žóhkile
with: be ~ one's own people	žókile
with: be, come, or go ~	žóle
with: go ~	oðáhaaðee
wither	púze
within: live ~ (e.g., a person's heart)	olį́į
without: be ~	ðįké, níðe
witness: be a ~	wawépahǫ
wobble	sísiąðe
wold: not ~	wacˀéka
wolf	šǫ́ke
Wolf (personal name)	šǫ́mįhkase
woman	wakˀó
woman (used in personal names)	wí
woman of bad reputation	wakˀó nǫǫhó
woman of the night (possibly a clan name?)	hą́ą tą wakˀó
woman: elderly ~	wakˀóžį
woman: married ~	wakˀó wéðuɣe
womanly	wakˀó éekǫ
wonder: I ~ (in speculative questions)	ną
wonderful	tąhé
woo	ðílą
wood	žą́ą
wood: fire-making ~	žą́ąhpeece
wooden spoon	žą́ąhcuke
woodpecker	žą́ą káahtahta
woods	žą́ą
woods: live in the ~	žą́ą olį́į
word, words	íe
word: clear ~	íe waská, íeska
word: get ~ of	opéni
word: one's ~	íe
work (noun)	oðíhtą, waðíhtą
work for	áwaši
work meat with the hand	htaaðíihtą
work something with the hand	ðiihtą́
work: do ~	waðíhtą
workaholic (one woh works all the time)	waðíhtąštą
worker: have the qualitities of a good ~	wahtóke
worker: hired ~	waší, wašížį
workplace	waðíhtą
workshop (for practicing or learning)	íkˀuce
world	mą́žą
world, all the world	níǫhta záani
world, whole world	mą́žą záani
world: upper ~	mą́ąɣe
worm	htamá, walúška, wáxta
worn out (tired)	kaaskíke
worn, worn out (said of clothing)	cúuða
worried: not ~	škaškáða
worry (noun)	waðílą waxpáðį
worry about	óðąąceši
worry about something verbally (as in a business meeting)	óie
worse	óhesaži
worst: be the ~	ochí
worth: be ~ looking at	tǫ́pewaðe
worthless	óškika
would	ðąąché
wrap	iðíši
wrap on's arms around	áace
wrap stuff as a bundle	ópetxą
wrap up	ápetxa
wrap up something specific	opétxą
wrapping, wrapper	ápetxa
wrestle one another	mą́hkisǫce
wrinkle	cˀį́ða
wrinkled	xúuða
write	páaleze
write a letter to	wáleze wi kaeíɣe
writer: be a ~	wápaleze káaɣe
writing (such as a letter)	wápaleze
wrong	ée htáhaži, ékǫži, íhtaháaži
wrong side out: turn ~	ðuháašįðe
wrong: what is ~ with	haakǫ́
wrongful acts (such as bad talk or theft)	ókˀą éži
wrongful, wrongly	ókˀą ekǫ́ži
wrongheaded: be ~	ókˀą éži
yam (sweet potato)	tooscée, tóoskue, tóožuuce
yard (lawn)	oštá
yard: by the ~	bróka
yardstick	žą́ą wéðaawa
yarn	wahą́
yarn belt: woman's ~	hceehį́į
yarnwork (as a product or activity)	wahą́ káaɣe
year	omą́įhka
yearly	omą́įhka wį́ hieną
yell	hóahtą, pą́
yellow	zí, zíhi
yes (female speaking)	ą́ą, ąhą́į
yes (male speaking)	howé
yes (response when listening to a story)	hąąé
yesterday	sitǫ́į
yolk of an egg	hpáatazi
yonder	kootáha, kootáįke
yonkapin	hcéwa
you (emphatic)	ðíe
you know?	hį́
you only	ðíną
young	wahókˀa
young men	nǫ́hǫžį
young person or people	hcéka hǫ́ǫ
your(s)	ðíhta, ðíhtaapi
youth (young person or peope)	hcéa nǫ́ǫ
zigzag	pažážaki
zip	oðíiną
