break with the hands (e.g., a dish, an egg, a light bulb, a window) - ğ“µğ“¶ğ“§ğ“Ÿğ“¤ğ“Ÿ (Ã°uulÃ©ke)
break wind - ğ“µğ“£ğ“¬ğ“£ğ“¹ğ“˜Í˜ (Ã°iipÃ­É£Ä…)
break wind (with a small noise, by letting the air out slowly) - ğ“µğ“£ğ“»ğ“£ğ“²ğ“Ÿ (Ã°iÅ¾Ã­ce)
break wind noisily - ğ“µğ“£ğ“œğ“£Í˜Ìğ“¹ğ“˜ (Ã°ibrÄ¯ÌÉ£a)
breakfast - ğ“¤ğ“˜ğ“®ğ“£Í˜Ìğ“Ÿğ“¸ğ“²ğ“£ ğ“·ğ“˜ğ“©ğ“ªÍ˜ğ“œğ“Ÿ (kaasÄ¯Ìexci wanÃ³Ì¨bre)
breakfast food - ğ“¤ğ“˜ğ“®ğ“£Í˜Ìğ“Ÿğ“¸ğ“²ğ“£ ğ“ªğ“©ğ“ªÍ˜ğ“œğ“Ÿ (kaasÄ¯Ìexci Ã³nÇ«bre)
breast - ğ“¬ğ“˜ğ“ºğ“Ÿ (paazÃ©)
breath: run out of ~ from - ğ“£ğ“¤ğ“˜ğ“®ğ“¤ğ“Ÿ (Ã­kaske)
breath: short of ~ - ğ“¡ğ“Ÿğ“¡ğ“Ÿ (hehÃ©)
breathe - ğ“ªğ“©ğ“£ğ“Ÿ (Ã³nie)
breathe hard - ğ“¡ğ“Ÿğ“¡ğ“˜ğ“¡ğ“˜ (hehÃ¡ha)
breathless: become ~ from - ğ“£ğ“¤ğ“˜ğ“®ğ“¤ğ“Ÿ (Ã­kaske)
breechcloth - ğ“¸ğ“£ğ“µğ“˜ğ“¸ğ“˜ (xÃ­Ã°axa)
breechloading shotgun - ğ“·ğ“˜ğ“¡ğ“ªğ“°ğ“˜Í˜ ğ“ªğ“¬ğ“˜ğ“¸ğ“ªÍ˜ (wahÃ³ohtÄ… opÃ¡axÇ«)
breeze - ğ“°ğ“˜ğ“²ğ“Ÿ (htaacÃ©)
briars - ğ“·ğ“˜ğ“¸ğ“˜ğ“¤ğ“˜ (waxÃ¡ka)
bridesmaid: have as a ~ - ğ“£ğ“µğ“¶ğ“¹ğ“Ÿ (Ã­Ã°uÉ£e)
bridge (noun) - ğ“»ğ“˜Í˜ğ“¤ğ“˜ğ“¸ğ“ªÍ˜ (Å¾Ä…ÌÄ…kaaxÃ³Ì¨)
bright - ğ“®ğ“¤ğ“˜Ìğ“¡ğ“˜ (skaÌha)
bright colors - ğ“¡ğ“£Í˜ (hÃ­Ì¨Ã­Ì¨)
bring - ğ“˜ğ“¤ğ“¶ (akÃº)
bring back here (motion underway) - ğ“˜ğ“µğ“£Í˜ğ“˜ğ“¤ğ“¶ (aÃ°Ã­Ì¨aku)
bring back here, bring back home (motion accomplished) - ğ“˜ğ“µğ“£Í˜ğ“˜ğ“§ğ“£ (aÃ°Ã­Ì¨ali)
bring back something that belongs to oneself - ğ“˜ğ“§ğ“˜ğ“µğ“£Í˜ğ“¤ğ“¶ (alÃ¡Ã°Ä¯ku)
bring back there (motion accomplished) - ğ“˜ğ“µğ“£Í˜Ìğ“˜ğ“¤ğ“¯ğ“£ (aÃ°Ä¯ÌakÅ¡i)
bring here (motion accomplished) - ğ“˜ğ“µğ“£Í˜Ìğ“˜ğ“²ğ“£ (aÃ°Ä¯Ìachi)
bring here (motion underway) - ğ“˜ğ“µğ“£Í˜Ìğ“˜ğ“¡ğ“¶ (aÃ°Ä¯Ìahu)
bring home (motion accomplished) - ğ“˜ğ“µğ“£Í˜Ìğ“˜ğ“¤ğ“¯ğ“£ (aÃ°Ä¯ÌakÅ¡i)
bring the parts of a whole together with pressure, bring components into contact - ğ“µğ“£ğ“®ğ“¤ğ“£ğ“¤ğ“Ÿ (Ã°iiskÃ­ke)
bring there (motion accomplished) - ğ“˜ğ“µğ“£Í˜Ìğ“˜ğ“¡ğ“£ (aÃ°Ä¯Ìahi)
bring up (rear or raise) - ğ“©ğ“ªÍ˜ğ“µğ“Ÿ (nÃ³Ì¨Ç«Ã°e)
Bristow: Robin ~ (personal name) - ğ“·ğ“˜ğ“»ğ“˜ğ“»ğ“Ÿğ“¨ğ“£Í˜Ìğ“£Í˜ğ“²ğ“Ÿğ“¸ğ“£Í˜ (waÅ¾Ã¡Å¾emÄ¯ÌÄ¯hcexÄ¯)
broad - ğ“œğ“˜ğ“µğ“˜ (brÃ¡aÃ°a), ğ“§ğ“˜Í˜ğ“µğ“Ÿ (lÃ¡Ì¨Ä…Ã°e)
broadcloth - ğ“¡ğ“˜ğ“¯ğ“°ğ“˜ğ“¡ğ“˜ (haaÅ¡tÃ¡ha)
broke (without money) - ğ“¸ğ“ªÍ˜ (xÃ³Ì¨)
broken - ğ“¸ğ“ªÍ˜ (xÃ³Ì¨)
broken: be ~ - ğ“¤ğ“˜ğ“§ğ“Ÿğ“¤ğ“Ÿ (kaalÃ©ke), ğ“¤ğ“˜ğ“¸ğ“ªÍ˜ (ğ“·ğ“¡ğ“Ÿğ“© ğ“¶ğ“®ğ“Ÿğ“µ ğ“·ğ“£ğ“°ğ“¡ ğ“²ğ“ªğ“©ğ“°ğ“£ğ“©ğ“¶ğ“˜ğ“°ğ“£vğ“Ÿ ğ“˜ğ“®ğ“¬ğ“Ÿğ“²ğ“° ğ“¨ğ“˜rğ“¤ğ“Ÿr ğ“˜ğ“¤ğ“¸ğ“˜ ğ“ªr ğ“˜ğ“¬ğ“˜) (kaaxÇ«Ì (when useÃ° with continuative aspect marker akxa or apa)), ğ“¸ğ“ªÍ˜ (xÃ³Ì¨)
broken heart - ğ“µğ“˜Í˜ğ“²ğ“Ÿ ğ“µğ“¶ğ“®ğ“˜ğ“¤ğ“£ (Ã°Ä…ÌÄ…ce Ã°uusÃ¡aki), ğ“µğ“˜Í˜ğ“²ğ“Ÿ ğ“¸ğ“ªÍ˜ (Ã°Ã¡Ì¨Ä…ce xÃ³Ì¨)
brooch - ğ“·ğ“˜ğ“¬ğ“˜ğ“¹ğ“˜ (wÃ¡paÉ£a)
broom - ğ“·ğ“Ÿğ“¤ğ“˜ğ“²ğ“¶ğ“¸ğ“Ÿ (wÃ©kaacuxe)
broth - ğ“°ğ“˜ğ“©ğ“£ (htaanÃ­i)
brother (specifically, older brother of a female) -   ( )
'to my older brother' (speaker is female) - ğ“·ğ“£ğ“²ğ“£Í˜ğ“°ğ“ª (wihcÃ­Ì¨to)
'your older brother' (addressee is female) - ğ“µğ“£ğ“²ğ“£Í˜ğ“°ğ“ª (Ã°ihcÃ­Ì¨to)
'her older brother' - ğ“£ğ“²ğ“£Í˜ğ“°ğ“ª (ihcÃ­Ì¨to)
brother (specifically, older brother of a male) -   ( )
'my older brother' (speaker is male) - ğ“·ğ“£ğ“»ğ“£Í˜ğ“µğ“Ÿ (wiÅ¾Ä¯Ã°e)
'your older brother' (addressee is male) - ğ“µğ“£ğ“»ğ“£Í˜ğ“µğ“Ÿ (Ã°iÅ¾Ä¯Ã°e)
'his older brother' - ğ“£ğ“»ğ“£Í˜ğ“µğ“Ÿ (iÅ¾Ã­Ì¨Ã°e)
brother (specifically, younger brother of a female) -   ( )
'my younger brother' (speaker is female) - ğ“·ğ“£ğ“®ğ“ªÍ˜ğ“Ÿğ“»ğ“£Í˜ (wisÃ³Ì¨eÅ¾Ä¯)
'your younger brother' (addressee is female) - ğ“µğ“£ğ“®ğ“ªÍ˜ğ“Ÿğ“»ğ“£Í˜ (Ã°isÇ«ÌeÅ¾Ä¯)
'her younger brother' - ğ“£ğ“®ğ“ªÍ˜ğ“Ÿğ“»ğ“£Í˜ (isÃ³Ì¨eÅ¾Ä¯)
brother (specifically, younger brother of a male) -   ( )
'my younger brother' (speaker is male) - ğ“·ğ“£ğ“®ğ“ªÍ˜ğ“¤ğ“˜ (wisÃ³Ì¨ka)
'your younger brother' (addressee is male) - ğ“µğ“£ğ“®ğ“ªÍ˜ğ“¤ğ“˜ (Ã°isÃ³Ì¨ka)
'his younger brother' - ğ“£ğ“®ğ“ªÍ˜ğ“¤ğ“˜ (isÃ³Ì¨ka)
brother: baby ~ (of a female) - ğ“¤ğ“¸ğ“˜ğ“¬ğ“˜Í˜ (kxÃ¡hpÄ…)
brother-in-law (specifically, brother-in-law of a male) -   ( )
'my brother in law' (speaker is male) - ğ“·ğ“£ğ“°ğ“˜Í˜ğ“¡ğ“˜ (wihtÄ…Ìha), ğ“°ğ“˜Í˜ğ“¡ğ“˜ (htÃ¡Ì¨ha)
'your brother in law' (addressee is male) - ğ“µğ“£ğ“°ğ“˜Ì¨ğ“¡ğ“˜ (Ã°ihtÃ¡Ì¨ha)
'his brother in law' - ğ“£ğ“°ğ“˜Ì¨ğ“¡ğ“˜ (ihtÃ¡Ì¨ha)
brother-in-law (specifically, brother-in-law of a female) -   ( )
'my brother in law' (speaker is female) - ğ“·ğ“£ğ“¯ğ“£ğ“¤'ğ“Ÿ  (wiÅ¡Ã­kË€e )
'your brother in law' (addressee is female) - ğ“µğ“£ğ“¯ğ“£ğ“¤'ğ“Ÿ (Ã°iÅ¡Ã­kË€e)
'her brother in law' - ğ“£ğ“®Ìğ“£ğ“¤'ğ“Ÿ (isÌÃ­kË€e)
brow - ğ“¬ğ“Ÿ (hpÃ©e)
brow: smooth ~ - ğ“¬ğ“Ÿğ“¯ğ“°ğ“˜ (hpeeÅ¡tÃ¡)
brown (adjective) - ğ“ºğ“£ğ“¡ğ“£ (zÃ­hi), ğ“ºğ“£ğ“ºğ“£ (zÃ­zi), ğ“»ğ“£ğ“¡ğ“£ (Å¾Ã­hi)
brown: light ~ (like the color of elk hide) - ğ“ªğ“¬ğ“¸ğ“˜Í˜ (Ã³pxÄ…), ğ“¡ğ“£Í˜ ğ“Ÿğ“¤ğ“ªÍ˜ (hÃ­Ì¨Ä¯ ekÃ³Ì¨)
brown (become brown by application of heat) - ğ“°ğ“˜ğ“ºğ“£ğ“¡ğ“£ (taazÃ­hi)
brown (i.e., to brown food) - ğ“°ğ“˜ğ“ºğ“£ğ“¡ğ“£ğ“µğ“Ÿ (taazÃ­hiÃ°e)
browned - ğ“°ğ“˜ğ“ºğ“£ğ“¡ğ“£ (taazÃ­hi)
brownie (elf) - ğ“¨ğ“£ğ“˜ğ“§ğ“ªÍ˜ğ“¯ğ“¤ğ“˜ (mÃ­alÇ«Å¡ka)
brush (verb) - ğ“¤ğ“˜ğ“¹ğ“¶ (kaaÉ£Ãº)
brush: wire ~ - ğ“·ğ“˜ğ“¤ğ“˜ğ“¬ğ“¯ğ“Ÿ (wÃ¡kaapÅ¡e)
brush (for the hair) - ğ“·ğ“Ÿğ“¤ğ“˜ğ“¬ğ“¯ğ“Ÿ (wÃ©kaapÅ¡e)
brush arbor - ğ“˜ğ“²ğ“£ğ“°ğ“˜Í˜ (Ã¡hcihtÄ…), ğ“·ğ“˜ğ“»ğ“˜ğ“£ğ“²ğ“£ (waÅ¾Ã¡ihci)
brush someone's hair - ğ“¤ğ“£ğ“¬ğ“¯ğ“Ÿ (kÃ­pÅ¡e)
brush the mane or coat of an animal - ğ“¤ğ“£ğ“¬ğ“¯ğ“Ÿ (kÃ­pÅ¡e), ğ“·ğ“˜ğ“¤ğ“˜ğ“¬ğ“¯ğ“Ÿ (wÃ¡kaapÅ¡e)
buck - ğ“°ğ“˜ (htÃ¡a), ğ“°ğ“˜ ğ“°ğ“˜Í˜ğ“¤ğ“˜ (htÃ¡a htÄ…Ìka)
bucket - ğ“²ğ“Ÿğ“¹ğ“Ÿ (cÃ©É£e)
buckeye tea - ğ“°ğ“˜ğ“¯ğ“¤ğ“˜ ğ“¡ğ“£ (htÃ¡Å¡ka hÃ­)
buckskin - ğ“°ğ“˜ğ“¡ğ“˜ (htaahÃ¡a)
buckskin dress - ğ“¡ğ“˜ğ“®ğ“¤ğ“˜ (haaskÃ¡)
bud on a tree - ğ“»ğ“˜Í˜ğ“§ğ“˜ (Å¾Ã¡Ì¨Ä…laa)
buddy - ğ“²ğ“ªğ“¯ğ“¬ğ“˜ (hcoÅ¡pÃ¡)
buffalo - ğ“µğ“ªğ“¸ğ“Ÿ (Ã°Ã³xe), ğ“²ğ“Ÿ (hcÃ©e)
buffalo: small ~ - ğ“²ğ“Ÿğ“»ğ“£Í˜ (hceeÅ¾Ã­Ì¨)
buffalo: young or small male ~ - ğ“²ğ“Ÿğ“°ğ“ªğ“Ÿğ“»ğ“£Í˜ğ“¤ğ“˜ (hceetÃ³eÅ¾Ä¯kÃ¡)
buffalo calf: unborn ~ - ğ“²ğ“Ÿğ“»ğ“£Í˜ (hceeÅ¾Ã­Ì¨)
Buffalo Chief (personal name) - ğ“µğ“ªğ“¸ğ“Ÿ ğ“¤ğ“˜ğ“¡ğ“£ğ“¤ğ“Ÿ (Ã°Ã³xe kahÃ­ke)
Buffalo Clan - ğ“µğ“ªğ“¸ğ“Ÿ (Ã°Ã³xe)
buffalo horn(s) - ğ“²ğ“Ÿğ“¡ğ“Ÿ (hcehÃ©)
bug - ğ“·ğ“˜ğ“§ğ“¶ğ“¯ğ“¤ğ“˜ (walÃºÅ¡ka)
bug with thick outer layer of exoskeleton - ğ“·ğ“˜ğ“§ğ“¶ğ“¯ğ“¤ğ“˜ ğ“¡ğ“˜ ğ“¯ğ“ªğ“¤ğ“˜ (walÃºÅ¡ka hÃ¡a Å¡ookÃ¡)
build - ğ“¤ğ“˜ğ“¹ğ“Ÿ (kÃ¡aÉ£e)
build a fireplace or fire - ğ“ªğ“²ğ“Ÿğ“µğ“Ÿ (ocÃ©Ã°e)
build for oneself - ğ“¤ğ“£ğ“¤ğ“˜ğ“¹ğ“Ÿ (hkihkÃ¡aÉ£e)
bulge - ğ“¬ğ“˜ (hpÃ¡)
bulk, in bulk - ğ“œğ“ªğ“¤ğ“˜ (brÃ³ka)
bull - ğ“²ğ“Ÿğ“®ğ“¤ğ“˜ğ“°ğ“ªğ“¤ğ“˜ (hceeskÃ¡tÃ³oka)
bun (woman's hairdo) - ğ“¬ğ“˜ğ“¸ğ“£Í˜ ğ“µğ“¶ğ“°ğ“˜ğ“¬ğ“˜ (hpÃ¡xÄ¯ Ã°uutÃ¡ahpa)
bunch: a whole ~ of - ğ“¡ğ“¶ğ“°ğ“˜Ì¨ğ“¤ğ“˜ (huuhtÃ¡Ì¨ka), ğ“¡ğ“¶ğ“·ğ“˜ğ“§ğ“£ (huuwÃ¡li)
bundle: gather and tie in a ~ - ğ“¬ğ“˜ğ“¸ğ“²ğ“Ÿ (paaxcÃ©)
burden: be a ~ to someone - ğ“ªğ“·ğ“ªÍ˜ ğ“¤ğ“˜ğ“¹ğ“Ÿ (Ã³wÇ« kÃ¡aÉ£e)
burdened: be ~ (e.g., with excessive woe) - ğ“£ğ“œğ“˜Í˜ğ“¸ğ“²ğ“£Í˜ (Ã­ibrÄ…xcÄ¯)
burgundy (color) - ğ“»ğ“¶ğ“²ğ“Ÿ ğ“®ğ“˜ğ“¬ğ“Ÿ (Å¾Ãºuce sÃ¡pe)
burial ground - ğ“ªğ“¸ğ“Ÿ ğ“¨ğ“˜Ì¨ğ“»ğ“˜Í˜ (Ã³xe mÃ¡Ì¨Å¾Ä…)
burial place - ğ“ªğ“¸ğ“Ÿ (Ã³xe)
burial stick (red stick put into a coffin at the head or foot, made of special wood) - ğ“¤ğ“˜Í˜ğ“²ğ“Ÿ ğ“»ğ“˜Í˜ (hkÃ¡Ì¨Ä…ce Å¾Ä…Ä…)
burn (verb) - ğ“ªğ“®ğ“˜ğ“£ (osÃ¡i), ğ“°ğ“˜ğ“µğ“£Í˜ğ“¤ğ“Ÿ ğ“¤ğ“˜ğ“¹ğ“Ÿ (tÃ¡aÃ°Ä¯ke kÃ¡aÉ£e), ğ“°ğ“˜ğ“§ğ“£Í˜ (tÃ¡alÄ¯)
burn cigarettes (as in a peyote meeting) - ğ“ªğ“®ğ“˜ğ“£ (osÃ¡i)
burn down, burn up - ğ“°ğ“˜ğ“µğ“£Í˜ğ“¤ğ“Ÿ ğ“¤ğ“˜ğ“¹ğ“Ÿ (tÃ¡aÃ°Ä¯ke kÃ¡aÉ£e)
burned - ğ“°ğ“˜ğ“§ğ“£Í˜ (tÃ¡alÄ¯)
burned meat - ğ“°ğ“˜ğ“®ğ“˜ğ“¤ğ“£ (tÃ¡asaaki)
burning - ğ“£ğ“·ğ“£ğ“§ğ“£ (Ã­wili)
burp - ğ“£ğ“¤'ğ“ª (Ã­kË€o), ğ“·ğ“˜ğ“·ğ“Ÿğ“¤'ğ“ª (wawÃ©kË€o)
burro - ğ“©ğ“˜Í˜ğ“°ğ“˜Í˜ğ“°ğ“˜Í˜ (nÄ…Ä…htÄ…ÌhtÄ…Ä…)
burry - ğ“·ğ“˜ğ“¸ğ“˜ğ“¤ğ“˜ (waxÃ¡ka)
burst - ğ“¤ğ“˜ğ“¬ğ“¸ğ“ªğ“¤ğ“Ÿ (kaapxÃ³hke)
bushy head - ğ“¡ğ“Ÿğ“¸ğ“¬ğ“˜ (hÃ©xpa)
business: run a ~ - ğ“ªğ“µğ“ªğ“·ğ“˜ğ“µğ“Ÿ (oÃ°Ã³waÃ°e)
busy - ğ“ªğ“·ğ“ªÍ˜ (Ã³wÇ«)
busybody (refers to someone who is into everything) - ğ“ªğ“¤'ğ“˜Í˜ğ“¯ğ“°ğ“˜Í˜ (Ã³kË€Ä…Å¡tÄ…)
but - ğ“˜Í˜ğ“»ğ“£ (Ä…Å¾i), ğ“¤ğ“ªğ“Ÿ (kÃ³e), ğ“©ğ“˜Í˜ (nÄ…)
butcher (noun) - ğ“·ğ“˜ğ“¬ğ“˜ğ“®ğ“Ÿ (wapÃ¡se)
butcher (verb) - ğ“¬ğ“˜ğ“²ğ“Ÿ (hpÃ¡ce), ğ“·ğ“˜ğ“¬ğ“˜ğ“²ğ“Ÿ (wahpÃ¡ce)
butter - ğ“¬ğ“˜ğ“ºğ“Ÿğ“©ğ“£ ğ“·ğ“Ÿğ“§ğ“£ (paazÃ©nii wÃ©li)
butterfly - ğ“¤ğ“£Í˜ğ“¤ğ“£Í˜ğ“Ÿğ“»ğ“£Í˜ (kÃ­Ì¨Ä¯kÄ¯Ä¯eÅ¾Ä¯)
buttocks - ğ“£Í˜ğ“§ğ“Ÿğ“¡ğ“˜ (Ä¯lÃ©ha), ğ“ªÍ˜ğ“¬ğ“Ÿ (Ã³Ì¨pe)
button - ğ“ªğ“µğ“£ğ“©ğ“˜Í˜ (oÃ°Ã­inÄ…)
button-snake-root (liatris punctata): dotted ~ - ğ“¨ğ“˜Í˜ğ“¤ğ“˜ ğ“®ğ“˜ğ“¤ğ“£ (mÄ…hkÃ¡ saakÃ­)
buy - ğ“µğ“¶ğ“·ğ“£Í˜Ì (Ã°uwÄ¯Ì)
buy for one's own (people, family) - ğ“§ğ“¶ğ“·ğ“£Í˜ (lÃºwÄ¯)
buy for oneself - ğ“¤ğ“£ğ“§ğ“¶ğ“·ğ“£Í˜ (hkÃ­luwÄ¯)
buy for someone - ğ“˜ğ“µğ“¶ğ“·ğ“£Í˜ (Ã¡Ã°uwÄ¯), ğ“¤ğ“£ğ“µğ“¶ğ“·ğ“£Í˜ (kÃ­Ã°uwÄ¯)
buy from someone (something that belongs to that person) - ğ“¤ğ“£ğ“µğ“¶ğ“·ğ“£Í˜ (kÃ­Ã°uwÄ¯)
buy something of one's own (buy back) - ğ“§ğ“¶ğ“·ğ“£Í˜ (lÃºwÄ¯)
buy stuff with something - ğ“·ğ“Ÿğ“µğ“¶ğ“·ğ“£Í˜ (wÃ©Ã°ÃºwÄ¯)
buy things - ğ“·ğ“˜ğ“µğ“¶ğ“·ğ“£Í˜ (waÃ°ÃºwÄ¯)
buy with - ğ“£ğ“µğ“¶ğ“·ğ“£Í˜ (Ã­Ã°uwÄ¯)
buzzard - ğ“¡ğ“Ÿğ“¤ğ“˜ (hÃ©ka)
by: pass ~ - ğ“˜ğ“¤ğ“£ğ“¹ğ“Ÿ (Ã¡kiÉ£e), ğ“£ğ“¬ğ“¯ğ“Ÿ (Ã­pÅ¡e)
by car - ğ“Ÿğ“·ğ“˜ğ“»ğ“£Í˜ ğ“©ğ“˜Í˜ğ“¤ğ“Ÿ (Ã©waÅ¾Ä¯ nÃ¡Ì¨Ä…ke), ğ“ªğ“µğ“£ğ“°ğ“˜Í˜ ğ“ªğ“§ğ“£Í˜ (oÃ°ihtÄ… olÃ­Ì¨Ä¯)
by extreme of temperature - ğ“°ğ“˜- (tÃ¡a-)
by foot ~ go ~ - ğ“¨ğ“˜Í˜ğ“µğ“£Í˜ (mÄ…Ã°Ã­Ì¨)
by hand - ğ“µğ“¶ -  (Ã°u - )
by heat or cold - ğ“°ğ“˜- (tÃ¡a-)
by means of - ğ“£- (Ã­-)
by mouth - ğ“µğ“˜- (Ã°aa-)
by oneself - ğ“Ÿğ“·ğ“˜ğ“»ğ“£Í˜ (Ã©waÅ¾Ä¯), ğ“ªğ“¤ğ“˜Í˜ğ“²ğ“£ (ohkÄ…Ìci)
by striking - ğ“¤ğ“˜- (kaa-)
by way of - ğ“¡ğ“˜ (ha)
cabbage - ğ“·ğ“Ÿğ“§ğ“£ğ“°ğ“˜Í˜ (wÃ©elihtÄ…Ä…)
cable - ğ“¨ğ“˜Í˜ğ“ºğ“Ÿ (mÄ…Ìze)
cache - ğ“©ğ“˜Í˜ğ“§ğ“ªÍ˜ğ“¤ğ“£ğ“§ğ“Ÿ (nÄ…lÃ³Ì¨Ç«hkile)
Caddo (tribe or tribal member) - ğ“¡ğ“£Í˜ğ“¯ğ“˜ (hÄ¯Ä¯Å¡Ã¡)
cafe - ğ“ªğ“·ğ“˜ğ“©ğ“ªÍ˜ğ“œğ“Ÿğ“²ğ“£ (owÃ¡nÇ«brehcÃ­)
cake (e.g., birthday cake) - ğ“·ğ“˜ğ“²ğ“¶ğ“Ÿ ğ“®ğ“¤ğ“¶ğ“µğ“Ÿ (wacÃºe skÃºÃ°e)
calf: unborn ~ - ğ“²ğ“Ÿğ“»ğ“£Í˜ (hceeÅ¾Ä¯)
call: phone ~ (noun) - ğ“¨ğ“˜Ì¨ğ“ºğ“Ÿğ“£ğ“Ÿ (mÃ¡Ì¨zeie)
call by name (verb) - ğ“µğ“˜ğ“²ğ“Ÿ (Ã°aacÃ©)
call by phone - ğ“¨ğ“˜Ì¨ğ“ºğ“Ÿğ“£ğ“Ÿ ğ“¡ğ“£ğ“µğ“Ÿ (mÃ¡Ì¨zeie hÃ­Ã°e), ğ“ªğ“¤ğ“£ğ“Ÿ (ohkÃ­e)
call by phone: have something ~ - ğ“¨ğ“˜Ì¨ğ“ºğ“Ÿğ“ªğ“¤ğ“£ğ“¤ğ“£ğ“Ÿ ğ“¡ğ“¶ğ“¤ğ“¯ğ“£ğ“Ÿ (mÃ¡Ì¨zeohkÃ­hkie hukÅ¡Ã­e)
call each other names - ğ“¤ğ“£ğ“§ğ“ªÍ˜(ğ“§ğ“ªÍ˜) (hkÃ­lÇ«(lÇ«))
call folks names - ğ“·ğ“˜ğ“§ğ“ªÍ˜ (walÇ«ÌÇ«)
call for folks (verb) - ğ“·ğ“˜ğ“¬ğ“˜Ì¨ (wapÃ¡Ì¨)
call loudly - ğ“¡ğ“ªğ“®ğ“˜ğ“¤ğ“£ (hÃ³osaaki)
call names - ğ“§ğ“ªÍ˜ğ“§ğ“ªÍ˜ (lÃ³Ì¨Ç«lÇ«Ç«)
call on someone's name - ğ“µğ“˜ğ“²ğ“Ÿ (Ã°aacÃ©)
call one's own, call one's own by name - ğ“§ğ“˜ğ“²ğ“Ÿ (lÃ¡ace)
call one's relative(s) - ğ“¤ğ“£ğ“¬ğ“˜Í˜ (kÃ­hpÄ…)
call someone a bad name - ğ“§ğ“ªÍ˜ (lÃ³Ì¨Ç«)
call to ask or summon s.o to attend or appear before others - ğ“¤ğ“£ğ“¬ğ“˜Í˜ (kÃ­pÄ…)
calling songs - ğ“·ğ“˜ğ“¬ğ“˜Í˜ ğ“·ğ“˜ğ“µğ“ªÍ˜ (wapÄ…Ì waaÃ°Ç«Ì)
calm (verb) - ğ“µğ“¶ğ“¯ğ“°ğ“˜ğ“¤ğ“˜ (Ã°uuÅ¡tÃ¡ka)
calm, calmly - ğ“¯ğ“¤ğ“˜ğ“¯ğ“¤ğ“˜ğ“µğ“˜ (Å¡kaÅ¡kÃ¡Ã°a)
calm (a person's ways or the weather) - ğ“¯ğ“°ğ“˜ğ“¤ğ“Ÿ (Å¡tÃ¡ke)
camp (verb) - ğ“˜ğ“²ğ“£ (ahcÃ­), ğ“²ğ“£ (hcÃ­)
can or other container for soda pop - ğ“©ğ“£ğ“¤ğ“˜ğ“¬ğ“¸ğ“ªğ“¤ğ“Ÿğ“ªğ“»ğ“¶ (niikÃ¡apxokeooÅ¾Ãº)
Canadian person - ğ“£Í˜ğ“¯ğ“°ğ“˜ğ“¸ğ“£Í˜ (Ä¯Ä¯Å¡tÃ¡xÄ¯)
candy - ğ“»ğ“˜Í˜ğ“©ğ“£ğ“Ÿğ“»ğ“£Í˜ (Å¾Ä…Ä…nÃ­eÅ¾Ä¯)
cane - ğ“£ğ“®ğ“˜ (Ã­isa)
cannot - ğ“µğ“˜Í˜ğ“²ğ“˜ğ“»ğ“£ (Ã°Ä…Ä…chÃ¡Å¾i), ğ“µğ“¶ğ“²'ğ“˜ğ“¤ğ“Ÿ (Ã°uucË€Ã¡ke)
cannot understand - ğ“¤ğ“£ğ“ªğ“¬ğ“¸ğ“˜ğ“»ğ“£ (kÃ­opxaÅ¾i)
cantaloupe - ğ“£Í˜ğ“¯ğ“°ğ“˜ğ“¸ğ“£Í˜ ğ“®ğ“˜ğ“¤ğ“¶ (Ä¯Ä¯Å¡tÃ¡xiÌ¨ sÃ¡hku)
cape - ğ“˜ğ“¤ğ“˜ğ“¡ğ“˜ğ“¨ğ“£Í˜ (Ã¡kahamÄ¯)
car - ğ“ªğ“µğ“£ğ“°ğ“˜Í˜ (oÃ°Ã­htÄ…)
car, by car - ğ“Ÿğ“·ğ“˜ğ“»ğ“£Í˜ ğ“©ğ“˜Í˜ğ“¤ğ“Ÿ (Ã©waÅ¾Ä¯ nÃ¡Ì¨Ä…ke)
car door - ğ“ªğ“µğ“£ğ“°ğ“˜Í˜ ğ“¡ğ“Ÿğ“£ğ“»ğ“Ÿ (oÃ°Ã­htÄ… heiÅ¾Ã©)
card: greeting or gift ~. - ğ“£ğ“Ÿ ğ“µğ“˜Ìğ“˜ğ“§ğ“£Í˜ ğ“»ğ“£Í˜ (Ã­e Ã°aÌalÄ¯ Å¾Ä¯)
card: lead or play a ~ (in a card game) - ğ“µğ“Ÿ ğ“¤ğ“˜ğ“¹ğ“Ÿ (Ã°Ã©e kÃ¡aÉ£e)
card game. - ğ“°ğ“˜ğ“©ğ“˜Í˜ğ“¤'ğ“˜ ğ“¤Ë€ğ“ªÍ˜ (htanÄ…ÌkË€a kË€Ç«Ì)
cardinal (bird) - ğ“·ğ“˜ğ“»ğ“£Í˜Ìğ“»ğ“¶ğ“Ÿ (waÅ¾Ä¯ÌÅ¾ue)
cards - ğ“°ğ“˜ğ“©ğ“˜Í˜ğ“¤'ğ“˜ ğ“¤Ë€ğ“ªÍ˜ (htanÄ…ÌkË€a kË€Ç«Ì)
cards: play ~ - ğ“°ğ“˜ğ“©ğ“˜Í˜ğ“¤'ğ“˜ ğ“¤Ë€ğ“ªÍ˜ (htanÄ…ÌkË€a kË€Ç«Ì)
cards: playing ~ (noun) - ğ“°ğ“˜ğ“©ğ“˜Í˜ğ“¤'ğ“˜ (htanÄ…ÌkË€a), ğ“°ğ“˜ğ“©ğ“˜Í˜ğ“¤'ğ“˜ ğ“µğ“£ğ“¡ğ“£ğ“²ğ“Ÿ (htanÄ…ÌkË€a Ã°iihÃ­ce)
care: have a ~ with regard to something or someone - ğ“£ğ“©ğ“ªÍ˜ğ“¬ğ“Ÿ (Ã­inÇ«Ç«hpe)
care: take ~ of - ğ“˜ğ“°ğ“ªÍ˜ğ“¬ğ“Ÿ (Ã¡tÇ«pe), ğ“µğ“˜ğ“¤'ğ“Ÿğ“µğ“Ÿ (Ã°akË€Ã©Ã°e), ğ“ªğ“¤ğ“˜ğ“¯ğ“˜Í˜ (okÃ¡Å¡Ä…), ğ“ªğ“¤ğ“˜ğ“¯ğ“Ÿ (okÃ¡Å¡e), ğ“·ğ“˜ğ“©ğ“˜ğ“¯ğ“Ÿ (wanÃ¡Å¡e)
car: take ~ of a meal oneself when asked to do so - ğ“ªğ“¤ğ“£ğ“¡ğ“˜Í˜ (Ã³ohkihÄ…)
care: take ~ of a task or an event - ğ“ªğ“µğ“ªğ“·ğ“˜ğ“µğ“Ÿ (oÃ°Ã³waÃ°e)
care: take ~ of oneself - ğ“ªğ“¤ğ“£ğ“¤ğ“˜ğ“¯ğ“Ÿ (Ã³hkihkaÅ¡e)
care for kids (babysit) - ğ“»ğ“£Í˜ğ“¤ğ“ªğ“¤ğ“˜ğ“¯ğ“˜Í˜ (Å¾Ä¯kÃ³kaÅ¡Ä…)
care for oneself - ğ“ªğ“¤ğ“£ğ“Ÿğ“»ğ“˜Í˜ (ohkÃ­eÅ¾Ä…)
care for the sick - ğ“¡ğ“¶ğ“¡ğ“Ÿğ“¤ğ“˜ ğ“ªğ“¤ğ“˜ğ“¯ğ“˜Í˜ (hÃºheka okÃ¡Å¡Ä…)
careful: be ~ with - ğ“£ğ“©ğ“ªÍ˜ğ“¬ğ“Ÿ (Ã­inÇ«Ç«hpe)
careful: not ~ - ğ“£ğ“©ğ“ªÍ˜ğ“¬ğ“˜ğ“»ğ“£ (Ã­inÇ«Ç«hpaÅ¾i)
caress - ğ“£ğ“¯ğ“ ğ“¤ğ“˜ (Ã­iÅ¡eÄ¯ka)
caress one's own - ğ“£ğ“¤ğ“£ğ“¯ğ“ ğ“¤ğ“˜ (Ã­ikiÅ¡eÄ¯ka)
carousel - ğ“¤ğ“ªÍ˜ğ“¤ğ“ªÍ˜ğ“Ÿ (kÇ«ÌkÇ«e)
carpet - ğ“ªğ“¨ğ“£ğ“»ğ“Ÿ (omÃ­Å¾e)
carrot - ğ“°ğ“ªğ“§ğ“Ÿğ“»ğ“£ (tÃ³oleÅ¾i)
carry - ğ“˜ğ“µğ“£Í˜ğ“˜ğ“µğ“Ÿ (aÃ°Ã­Ì¨aÃ°ee), ğ“£Í˜ (Ã­Ì¨), ğ“¤'ğ“£Í˜ (kË€Ã­Ì¨), ğ“¤'ğ“£Í˜ğ“˜ğ“¡ğ“£ (kË€Ã­Ì¨ahi)
carry on in a certain way - ğ“˜ğ“¤ğ“£ğ“§ğ“˜ğ“µğ“£Í˜ (ahkÃ­laÃ°Ã­Ì¨)
carry on the back - ğ“¤'ğ“£Í˜ (kË€Ã­Ì¨)
carry one's items, carry along one's items - ğ“˜ğ“§ğ“˜ğ“ªğ“£Í˜ (alÃ¡oÃ­Ì¨)
carry one's own - ğ“˜ğ“§ğ“˜ğ“µğ“£Í˜ (alÃ¡Ã°Ã­Ì¨)
carry oneself - ğ“˜ğ“¤ğ“£ğ“§ğ“˜ğ“µğ“£Í˜ (ahkÃ­laÃ°Ã­Ì¨)
carry piggyback - ğ“µğ“¶ğ“¯ğ“¤ğ“˜ğ“¬ğ“˜ (Ã°uÅ¡kÃ¡pa)
Carrying-and-Wailing (personal name) - ğ“·ğ“˜ğ“£Í˜ğ“¹ğ“˜ğ“¤ğ“Ÿ (wÃ¡Ã­Ì¨É£aakÃ©)
carrying the charcoal (mourning dance) - ğ“·ğ“˜ğ“¯ğ“˜ğ“¬ğ“Ÿ ğ“˜ğ“µğ“£Í˜ (waÅ¡Ã¡pe aÃ°Ã­Ì¨)
cash payment - ğ“·ğ“˜ğ“¤ğ“£ğ“§ğ“˜ğ“Ÿ ğ“·ğ“˜ğ“¤ğ“˜ğ“®ğ“¶ğ“¬ğ“Ÿ (wahkÃ­lae wakÃ¡supe)
cast a spell on someone - ğ“¤ğ“£ğ“§ğ“ªÍ˜ğ“»ğ“Ÿ (kilÃ³Ì¨Å¾e)
castor oil - ğ“·ğ“Ÿğ“§ğ“£ ğ“¨ğ“˜Í˜ğ“¤ğ“˜Ì¨ (wÃ©li mÄ…hkÃ¡Ì¨)
cat - ğ“£ğ“§ğ“ªÍ˜ğ“Ÿğ“»ğ“£ (ilÃ³Ì¨eÅ¾i)
catch - ğ“ªğ“µğ“£Í˜ğ“¤ğ“Ÿ (oÃ°Ã­Ì¨Ä¯ke)
catch on something - ğ“£ğ“¤ğ“ªğ“·ğ“˜ (Ã­hkowa)
categorize - ğ“¬ğ“˜ğ“¡ğ“£ğ“¤ğ“Ÿ (hpahÃ­ke)
caterpillar - ğ“·ğ“˜ğ“¸ğ“°ğ“˜ (wÃ¡xta)
catfish - ğ“°ğ“ªğ“ºğ“Ÿ (htÃ³ze)
Catholic (noun, adjective) - ğ“¯ğ“ªÍ˜ğ“¨ğ“£Í˜ğ“¤ğ“˜ (Å¡Ç«mÃ­Ì¨hka)
cattle: head of ~ - ğ“¡ğ“Ÿğ“Ÿğ“®ğ“¤ğ“˜ (heÃ©eska)
caught on something: get ~ - ğ“£ğ“¤ğ“ªğ“·ğ“˜ (Ã­hkowa)
causative markers - ğ“µğ“Ÿ (Ã°e), ğ“¤ğ“£ğ“µğ“Ÿ (hkiÃ°e), ğ“¤ğ“˜ğ“¹ğ“Ÿ (kÃ¡aÉ£e), ğ“¤ğ“£ğ“µğ“Ÿ (kÃ­Ã°e), ğ“¤ğ“¯ğ“£ğ“µğ“Ÿ (kÅ¡Ã­Ã°e), ğ“¤ğ“¯ğ“£ğ“¹ğ“Ÿ (kÅ¡Ã­É£e)
cause oneself ill or harm - ğ“¤ğ“£ğ“§ğ“¶ğ“¬ğ“£ğ“»ğ“£ (hkilÃºhpiiÅ¾i)
cause oneself to be or do - ğ“¤ğ“£ğ“µğ“Ÿ (hkÃ­Ã°e)
cause something to be a certain way - ğ“¤ğ“˜ğ“¹ğ“Ÿ (kÃ¡aÉ£e)
cause to be for someone - ğ“£ğ“¤ğ“£ğ“¤ğ“˜ğ“¹ğ“Ÿ (Ã­kikaaÉ£e)
cause to be or get lost - ğ“ªğ“¸ğ“¬ğ“˜ğ“µğ“Ÿ ğ“¤ğ“˜ğ“¹ğ“Ÿ (oxpÃ¡Ã°e kÃ¡aÉ£e), ğ“ªğ“¸ğ“¬ğ“˜ğ“µğ“Ÿğ“µğ“Ÿ (oxpÃ¡Ã°eÃ°e)
cause to fly out in pieces or splinter - ğ“¬ğ“˜ğ“®Ìğ“£ğ“¤ğ“Ÿ (paasÌike)
cause to go - ğ“µğ“Ÿğ“µğ“Ÿ (Ã°Ã©eÃ°e)
cause to smell, as in making cedar smoke for a cleansing or blessing - ğ“ªğ“µğ“£ğ“œğ“˜Í˜ (oÃ°Ã­brÄ…)
cedar - ğ“¸ğ“ªÍ˜ğ“²ğ“Ÿ (xÇ«ÌÇ«ce)
cedar tea - ğ“¸ğ“ªÍ˜ğ“²ğ“Ÿğ“©ğ“£ (xÇ«Ç«cÃ©nii)
cease (transitive) - ğ“¤ğ“˜ğ“¯ğ“°ğ“˜Ì¨ (kaaÅ¡tÃ¡Ì¨), ğ“¤ğ“˜ğ“¤ğ“ªÍ˜ğ“©ğ“˜Í˜ (kaakÇ«ÌnÄ…), ğ“¤ğ“˜ğ“¹ğ“Ÿ (kÃ¡aÉ£e)
cellar - ğ“¨ğ“˜Í˜ğ“£Í˜ğ“¤ğ“˜ğ“¯ğ“£ (mÃ¡Ì¨Ä¯hkaÅ¡i)
cemetery - ğ“ªğ“¸ğ“Ÿ ğ“¨ğ“˜Í˜ğ“»ğ“˜Í˜ (Ã³xe mÄ…ÌÅ¾Ä…)
censure (verb) - ğ“¤ğ“˜ğ“ºğ“˜Í˜ (kaazÄ…Ì)
cent - ğ“·ğ“˜ğ“µğ“˜ğ“·ğ“˜ğ“»ğ“£Í˜Ì (waÃ°Ã¡awaÅ¾Ä¯Ì)
center - ğ“ªğ“¤ğ“˜Ì¨ğ“®ğ“¤ğ“˜ (ohkÃ¡Ì¨ska)
center: at the or in the ~ - ğ“¨ğ“˜Í˜ğ“²ğ“Ÿ (mÄ…chÃ©), ğ“ªğ“¤ğ“˜Í˜ğ“®ğ“¤ğ“˜ (ohkÄ…Ìska)
center: toward the ~ - ğ“¨ğ“˜Í˜ğ“²ğ“Ÿğ“°ğ“˜ğ“¡ğ“˜ (mÄ…chÃ©htaha)
cents: five - ğ“·ğ“˜ğ“µğ“˜ğ“·ğ“˜ ğ“®ğ“˜ğ“°ğ“˜Í˜ (waÃ°Ã¡awa sÃ¡htÄ…)
cereal - ğ“¤ğ“˜ğ“®ğ“£Í˜Ìğ“Ÿğ“¸ğ“²ğ“£ ğ“ªğ“©ğ“ªÍ˜ğ“œğ“Ÿ (kaasÄ¯Ìexci Ã³nÇ«bre)
ceremonial dances of the Osages - ğ“£ğ“§ğ“ªÍ˜ğ“¯ğ“¤ğ“˜ (ilÃ³Ì¨Ç«Å¡ka)
certain way; live or be a ~ - ğ“µğ“£Í˜ (Ã°Ã­Ì¨), ğ“¨ğ“˜Í˜ğ“µğ“£Í˜ (mÄ…Ã°Ã­Ì¨)
certainty of a future event - ğ“µğ“Ÿ ğ“°ğ“˜ ğ“²ğ“Ÿ (Ã°Ã©e hta chÃ©)
chair - ğ“˜ğ“§ğ“£Í˜ (Ã¡alÄ¯Ä¯), ğ“˜ğ“§ğ“£Í˜ (Ã¡lÄ¯Ä¯)
chaise longue - ğ“˜ğ“§ğ“£Í˜ğ“®ğ“²ğ“Ÿ (Ã¡lÄ¯Ä¯scee)
challenging - ğ“·ğ“˜ğ“²ğ“Ÿğ“¸ğ“£ (wahcÃ©xi)
change (transitive) - ğ“µğ“¶ğ“Ÿğ“»ğ“£ (Ã°ÃºeÅ¾i)
change: make or make a ~ - ğ“£ğ“¤ğ“£ğ“¤ğ“š ğ“¤ğ“˜ğ“¹ğ“Ÿ (Ã­hkihkaÄ¯ kÃ¡aÉ£e)
change (as the weather) - ğ“¯ğ“¤ğ“˜Í˜ (Å¡kÄ…Ì)
change (money, coins) - ğ“£ğ“¤ğ“£ğ“¤ğ“˜ğ“·ğ“£Í˜ (Ã­hkihkawÄ¯), ğ“ªğ“¯ğ“¬ğ“Ÿğ“»ğ“£Í˜ (oÅ¡pÃ©Å¾Ä¯), ğ“·ğ“˜ğ“µğ“˜ğ“·ğ“˜ğ“»ğ“£Í˜ (waÃ°Ã¡awaÅ¾Ä¯)
change one's mind - ğ“·ğ“˜ğ“µğ“£ğ“§ğ“˜Í˜ ğ“¤ğ“£ğ“¤ğ“˜ğ“¹ğ“Ÿ (waÃ°Ã­lÄ… kikÃ¡aÉ£e)
change one's ways - ğ“¤ğ“£ğ“§ğ“£ğ“®ğ“˜Í˜ (hkilÃ­isÄ…)
change (intransitive) - ğ“£ğ“¤ğ“£ğ“¤ğ“˜ğ“·ğ“£Í˜ ğ“¤ğ“˜ğ“¹ğ“Ÿ (Ã­hkihkawÄ¯ kÃ¡aÉ£e)
changeable - ğ“Ÿğ“»ğ“£ğ“¸ğ“²ğ“£ (Ã©Å¾ixci)
characteristics: personal ~ - ğ“ªğ“¤'ğ“˜Í˜ (Ã³kË€Ä…)
charcoal accompanying them (ceremonial title) - ğ“·ğ“˜ğ“¯ğ“˜ğ“¬ğ“Ÿ ğ“˜ğ“µğ“£Í˜Ì ğ“·ğ“˜ğ“»ğ“ªÌğ“·ğ“˜ğ“§ğ“Ÿ (waÅ¡Ã¡pe aÃ°Ä¯Ì waÅ¾oÌwale)
charge: be in ~ of - ğ“ªğ“µğ“ªğ“µğ“Ÿ (oÃ°Ã³Ã°e)
charge: in ~ - ğ“ªğ“µğ“ªğ“·ğ“˜ğ“µğ“Ÿ (oÃ°Ã³waÃ°e), ğ“ªğ“¤ğ“£ğ“¡ğ“˜Í˜ (Ã³ohkihÄ…)
charge: take ~ of - ğ“ªğ“¤ğ“˜ğ“¯ğ“˜Í˜ (Ã³kaÅ¡Ä…)
charred meat - ğ“°ğ“˜ğ“®ğ“˜ğ“¤ğ“£ (tÃ¡asaaki)
chart of land. - ğ“¨ğ“˜Í˜ğ“»ğ“˜Í˜ğ“·ğ“˜ğ“§ğ“Ÿğ“ºğ“Ÿ (mÄ…Å¾Ä…Ìwaleze)
chase (verb) - ğ“µğ“¶ğ“¸ğ“£ (Ã°uxÃ­), ğ“ªğ“§ğ“Ÿ (olÃ©)
chase away - ğ“ªğ“§ğ“Ÿ (olÃ©)
chastise - ğ“¤ğ“˜ğ“ºğ“˜Í˜ (kaazÄ…Ì)
chauffeur - ğ“·ğ“˜ğ“µğ“£ğ“°ğ“˜Í˜ ğ“·ğ“˜ğ“¤ğ“˜ğ“»ğ“£ (waÃ°Ã­htÄ… wakÃ¡aÅ¾i), ğ“·ğ“˜ğ“¤ğ“˜ğ“»ğ“£ (wakÃ¡aÅ¾i)
cheap - ğ“ªğ“¨ğ“˜Í˜ğ“¤ğ“˜ (Ã³mÄ…hka)
check a horse's forward movement - ğ“ªğ“µğ“£ğ“°ğ“˜Í˜ (oÃ°Ã­itÄ…)
cheerful - ğ“ªğ“¤'ğ“˜Í˜ ğ“µğ“˜ğ“§ğ“£Í˜ (Ã³kË€Ä… Ã°aalÄ¯)
cheese - ğ“¬ğ“˜ğ“ºğ“Ÿğ“©ğ“£ ğ“®ğ“˜ğ“¤ğ“£ (paazÃ©nii saakÃ­), ğ“¬ğ“˜ğ“ºğ“Ÿğ“©ğ“£ ğ“·ğ“Ÿğ“§ğ“£ ğ“®ğ“˜ğ“¤ğ“£ (paazÃ©nii wÃ©li saakÃ­)
cherish each other - ğ“ªğ“¸ğ“°ğ“˜ğ“¤ğ“£ğ“µğ“Ÿ (Ã³xtahkiÃ°e)
cherish one's own - ğ“¤ğ“£ğ“ªğ“¸ğ“°ğ“˜ (kÃ­oxta)
cherished - ğ“ªğ“¸ğ“°ğ“˜ (Ã³xta)
Cherokee (tribe or tribal member) - ğ“¯ğ“˜ğ“¤ğ“Ÿ (Å¡aÃ¡ke), ğ“¯ğ“˜ğ“§ğ“˜ğ“¤ğ“£ (Å¡Ã¡laki)
chest (box) - ğ“»ğ“˜Í˜ğ“¤ğ“ªğ“¤ğ“Ÿ (Å¾Ä…ÌÄ…hkoke)
chest (of the body) - ğ“¨ğ“˜Í˜ğ“¤ğ“Ÿ (mÃ¡Ì¨Ä…ke)
chew - ğ“µğ“˜ğ“¯ğ“¤ğ“£ğ“¤ğ“Ÿ (Ã°aaÅ¡kÃ­ke)
chicken - ğ“®ğ“¶ğ“¤ğ“˜ (sÃºhka)
chewing gum - ğ“¨ğ“£Í˜ğ“°ğ“ªÍ˜ğ“Ÿğ“§ğ“£ (mÃ­Ì¨Ä¯htÇ«eli)
Cheyenne (tribe or tribal members) - ğ“°ğ“˜ğ“²ğ“Ÿğ“ªğ“¨ğ“˜Ì¨ğ“£ (htÃ¡aceomÃ¡Ì¨i)
chicken: banty (bantam) ~ - ğ“®ğ“¶ğ“¤ğ“˜ ğ“®ğ“˜ğ“¤ğ“£ (sÃºhka saaki)
chicken: prairie ~ - ğ“¨ğ“ªÍ˜ğ“©ğ“ªÍ˜ğ“£Í˜ (mÃ³Ì¨nÇ«Ä¯)
chief - ğ“¤ğ“˜ğ“¡ğ“£ğ“¤ğ“Ÿ (kahÃ­ke)
chief: be ~ (over a people) - ğ“¤ğ“£ğ“¡ğ“£ğ“¤ğ“Ÿ (kÃ­hike)
chief-to-chief (succession of hereditary chiefs within a family) - ğ“ªğ“¬ğ“¸ğ“˜Í˜ğ“¬ğ“¸ğ“˜Í˜ (opxÄ…ÌpxÄ…Ì)
child, children - ğ“»ğ“£Í˜ğ“¤ğ“˜ (Å¾Ä¯kÃ¡), ğ“»ğ“£Í˜ğ“¤ğ“˜ğ“»ğ“£Í˜ (Å¾Ä¯kÃ¡Å¾Ä¯)
childbirth - ğ“·ğ“Ÿğ“°ğ“˜ğ“µğ“Ÿ (wÃ©etaÃ°e)
childcare - ğ“»ğ“£Í˜ğ“¤ğ“ªğ“¤ğ“˜ğ“¯ğ“˜Í˜ (Å¾Ä¯kÃ³kaÅ¡Ä…)
childhood - ğ“»ğ“£Í˜ğ“¤ğ“˜ğ“»ğ“£Í˜ (Å¾Ä¯kÃ¡Å¾Ä¯)
childless - ğ“·ğ“Ÿğ“°ğ“˜ğ“µğ“˜ğ“»ğ“£ (wÃ©etaÃ°aÅ¾i)
children: take care of ~ - ğ“»ğ“£Í˜ğ“¤ğ“ªğ“¤ğ“˜ğ“¯ğ“˜Í˜ (Å¾Ä¯kÃ³kaÅ¡Ä…)
children in their teens - ğ“²ğ“Ÿğ“¤ğ“˜ ğ“©ğ“ªÍ˜ (hcÃ©ka nÇ«ÌÇ«)
chin - ğ“µğ“ŸÌğ“Ÿğ“¬ğ“˜ (Ã°eÌepa)
chip (noun) - ğ“ªğ“¯ğ“¬ğ“Ÿğ“»ğ“£Í˜ (oÅ¡pÃ©Å¾Ä¯)
choke from - ğ“£ğ“¤ğ“˜ğ“®ğ“¤ğ“Ÿ (Ã­kaske)
choke with the hands - ğ“°ğ“ªğ“²ğ“Ÿ ğ“ªğ“µğ“£Í˜ğ“¤ğ“Ÿ (tÃ³oce oÃ°Ã­Ì¨Ä¯ke)
choker (necklace) - ğ“·ğ“˜ğ“©ğ“ªÍ˜ğ“¬'ğ“£Í˜ (wanÃ³Ì¨pË€Ä¯)
choose - ğ“µğ“¶ğ“ºğ“Ÿ (Ã°uuzÃ©), ğ“¤ğ“£ğ“¬ğ“˜ğ“¡ğ“£ (hkÃ­hpaahi)
choose people (or things?) - ğ“·ğ“˜ğ“¬ğ“˜ğ“¡ğ“£ (wapÃ¡ahi)
chop (verb) - ğ“µğ“£ğ“§ğ“ªÍ˜ğ“»ğ“Ÿ (Ã°ilÇ«ÌÅ¾e)
chop by striking with - ğ“£ğ“¤ğ“˜ğ“®ğ“Ÿ (Ã­kaase)
chop down, chop up (e.h., with and axe or a knife) - ğ“¤ğ“˜ğ“®ğ“Ÿ (kaasÃ©)
chop with a blade (e.g., wood for a fire) - ğ“¤ğ“˜ğ“®ğ“Ÿ (kaasÃ©)
chore - ğ“ªğ“·ğ“ªÍ˜ (Ã³wÇ«)
chorus (female) - ğ“ªğ“µğ“˜ğ“ºğ“ª (oÃ°Ã¡azo)
Christmas - ğ“·ğ“˜ğ“¤ğ“ªÍ˜ğ“°ğ“˜ ğ“£ğ“»ğ“£Í˜ğ“¤ğ“Ÿ ğ“£ğ“¤ğ“£ğ“°ğ“˜ğ“µğ“Ÿ (wahkÃ³Ì¨ta iÅ¾Ã­Ì¨ke Ã­ikitaÃ°e), ğ“¸ğ“ªÍ˜ğ“²ğ“Ÿğ“¡ğ“¶ ğ“¤ğ“˜ğ“¹ğ“Ÿ ğ“¡ğ“ªÍ˜ğ“¬ğ“˜ (xÇ«Ç«cÃ©hu kÃ¡aÉ£e hÇ«ÌÇ«pa)
chubby - ğ“§ğ“˜Í˜ğ“µğ“Ÿğ“°ğ“˜Í˜ (lÃ¡Ì¨Ä…Ã°ehtÄ…)
church - ğ“·ğ“˜ğ“°ğ“˜ğ“£ğ“²ğ“£ (waatÃ¡ihci), ğ“·ğ“˜ğ“¤ğ“ªÍ˜ğ“°ğ“˜ğ“²ğ“£ (wahkÃ³Ì¨tahci), ğ“·ğ“£ğ“¤ğ“£ğ“Ÿğ“²ğ“£ (wÃ­kiehci)
church: little ~ - ğ“·ğ“£ğ“¤ğ“£ğ“²ğ“£ğ“»ğ“£Í˜ (wÃ­kihciÅ¾Ä¯)
church bell - ğ“£ğ“¤ğ“˜ğ“°ğ“˜ğ“¨ğ“˜Í˜ (Ã­ikaahtamÄ…)
church house: Native American ~ - ğ“²ğ“£ğ“¬ğ“ªğ“¹ğ“˜ (hcipÃ³É£a)
cigarette - ğ“©ğ“˜Í˜ğ“©ğ“£Í˜ğ“ªÍ˜ğ“¬ğ“˜ğ“»ğ“£Í˜ (nÄ…nÃ­Ì¨Ç«paÅ¾Ä¯)
cigarette: roll a ~ - ğ“©ğ“˜Í˜ğ“©ğ“£Í˜ğ“ªÍ˜ğ“¬ğ“˜ ğ“¤ğ“˜ğ“¹ğ“Ÿ (nÄ…nÃ­Ì¨Ç«pa kÃ¡aÉ£e)
circle around - ğ“˜ğ“¤ğ“£ğ“¹ğ“Ÿ (Ã¡kiÉ£e)
circular - ğ“°ğ“˜ğ“¬ğ“˜ (tÃ¡ahpa)
circulate - ğ“˜ğ“¬ğ“¯ğ“Ÿ (Ã¡pÅ¡e)
circus - ğ“ªğ“·ğ“˜ğ“°ğ“« (Ã³watoÄ¯)
clan - ğ“°ğ“˜Ì¨ğ“·ğ“˜Í˜ğ“§ğ“˜ (htÃ¡Ì¨wÄ…la), ğ“£ğ“©ğ“£ğ“¤ğ“˜ğ“¯ğ“£ğ“Ÿ (inihkaÅ¡ie)
clan subdivision (of Deer clan) - ğ“©ğ“ªÍ˜ğ“¬ğ“¸ğ“˜ğ“°ğ“˜ (nÃ³Ì¨pxata)
clap (e.g., the hands) - ğ“©ğ“˜Í˜ğ“®ğ“˜Í˜ğ“®ğ“˜Í˜ğ“·ğ“˜ (nÄ…sÄ…ÌsÄ…wa)
clarify - ğ“·ğ“˜ğ“µğ“˜ğ“®ğ“¤ğ“˜ (wÃ¡Ã°aaska)
class - ğ“£ğ“¤'ğ“¶ğ“²ğ“Ÿ (Ã­kË€uce), ğ“·ğ“˜ğ“§ğ“Ÿğ“ºğ“Ÿğ“˜ğ“²ğ“Ÿ (walÃ©zeÃ¡ace)
class: what ~ of - ğ“°ğ“˜ğ“°ğ“˜Í˜ (tÃ¡atÄ…)
classify - ğ“¬ğ“˜ğ“¡ğ“£ğ“¤ğ“Ÿ (hpahÃ­ke)
clatter (verb) - ğ“°ğ“˜ğ“°ğ“˜ğ“ºğ“Ÿ (htÃ¡htaze)
claw - ğ“¯ğ“˜ğ“¤ğ“Ÿ (Å¡Ã¡ake)
clay - ğ“¨ğ“˜Í˜ğ“£Í˜ğ“¤ğ“˜ (mÄ…ÌÄ¯hka)
clean (verb) - ğ“µğ“¶ğ“·ğ“˜ğ“®ğ“¶ (Ã°uuwÃ¡su)
clean, cleanly - ğ“·ğ“˜ğ“®ğ“¶ğ“¡ğ“¶ (wasÃºhu)
clean (e.g., the house) - ğ“µğ“£ğ“²ğ“£ğ“ºğ“Ÿ (Ã°icÃ­ze)
clean off - ğ“¬ğ“¶ğ“¹ğ“˜ (pÃºÉ£a)
clean off by wiping - ğ“¬ğ“¶ğ“¤ğ“¸ğ“˜ (pÃºkxa)
clean oneself - ğ“¤ğ“£ğ“§ğ“¶ğ“·ğ“˜ğ“®ğ“¶ (hkilÃºuwasu)
clean talk - ğ“£ğ“Ÿ ğ“·ğ“˜ğ“®ğ“¶ğ“¡ğ“¶ (Ã­e wasÃºhu)
clean up - ğ“µğ“¶ğ“·ğ“˜ğ“®ğ“¶ (Ã°uuwÃ¡su)
cleanse - ğ“µğ“¶ğ“·ğ“˜ğ“®ğ“¶ (Ã°uuwÃ¡su)
cleanse or be clean by heat or cold - ğ“°ğ“˜ğ“®ğ“¶ğ“¡ğ“¶ (taasÃºhu)
clear (adjective) - ğ“®ğ“¤ğ“˜ (skÃ¡), ğ“®ğ“¤ğ“˜ğ“¡ğ“˜ (skÃ¡ha), ğ“®ğ“°ğ“˜ (stÃ¡), ğ“·ğ“˜ğ“®ğ“¶ğ“¡ğ“¶ (wasÃºhu)
clear: make ~ - ğ“·ğ“˜ğ“µğ“˜ğ“®ğ“¤ğ“˜ (wÃ¡Ã°aaska)
clear (as the weather) - ğ“µğ“˜ğ“§ğ“£Í˜ (Ã°Ã¡alÄ¯)
clear language - ğ“£ğ“Ÿğ“®ğ“¤ğ“˜ (Ã­eska)
clear sky (as after a storm) - ğ“¤ğ“Ÿğ“µğ“ª (hkÃ©Ã°o)
clear speaking - ğ“£ğ“Ÿ ğ“·ğ“˜ğ“®ğ“¶ğ“¡ğ“¶ (Ã­e wasÃºhu)
clear words - ğ“£ğ“Ÿ ğ“·ğ“˜ğ“®ğ“¤ğ“˜ (Ã­e waskÃ¡), ğ“£ğ“Ÿğ“®ğ“¤ğ“˜ (Ã­eska)
clearance (space) - ğ“ªğ“°ğ“˜Í˜ğ“©ğ“˜Í˜ (ohtÄ…ÌnÄ…)
cleared off area - ğ“ªğ“¯ğ“°ğ“˜ (oÅ¡tÃ¡)
clearly - ğ“®ğ“¤ğ“˜ğ“¡ğ“˜ (skÃ¡ha), ğ“®ğ“¤ğ“˜ (skÃ¡), ğ“·ğ“˜ğ“µğ“ªğ“°ğ“˜Í˜ (wÃ¡Ã°ohtÄ…), ğ“·ğ“˜ğ“®ğ“¶ğ“¡ğ“¶ (wasÃºhu)
clearly: speak ~ - ğ“£ğ“Ÿ ğ“µğ“˜ğ“·ğ“˜ğ“®ğ“¤ğ“˜ (Ã­e Ã°Ã¡awaska), ğ“£ğ“Ÿğ“®ğ“¤ğ“˜ ğ“·ğ“˜ğ“µğ“˜ğ“®ğ“¤ğ“˜ (Ã­eska wÃ¡Ã°aaska)
clear-minded - ğ“©ğ“˜Í˜ğ“¹ğ“Ÿğ“®ğ“¤ğ“˜ (nÃ¡Ì¨Ä…É£eska)
clicking noise against metal (as made by a typewriter) - ğ“¨ğ“˜Í˜ğ“ºğ“Ÿ ğ“°ğ“˜ğ“°ğ“˜ğ“ºğ“Ÿ (mÄ…Ìze htÃ¡htaze)
clicking sound - ğ“°ğ“˜ğ“°ğ“˜ğ“ºğ“Ÿ (htÃ¡ahtaze)
cliffs: dwelling on the ~ - ğ“¬ğ“˜ğ“®ğ“¶ ğ“ªğ“§ğ“£Í˜ (hpasÃº olÃ­Ì¨Ä¯)
climb, climb onto (by using the arms) - ğ“˜ğ“²ğ“Ÿ (Ã¡ace)
climbing (by wrapping around?) - ğ“˜ğ“°ğ“¸ğ“˜Í˜ (Ã¡txÄ…)
clock - ğ“¨ğ“£Í˜ğ“ªğ“µğ“˜ğ“¤ğ“Ÿ (mÃ­Ì¨Ä¯oÃ°aake)
close (verb) - ğ“¤ğ“˜ğ“®ğ“£Í˜ğ“²ğ“Ÿ (kaasÃ­Ì¨ce)
close (e.g., one's eyes) - ğ“˜ğ“¬ğ“£ğ“®ğ“˜Í˜ (Ã¡pisÄ…)
close (near), closeby - ğ“˜ğ“¯ğ“¤ğ“˜ (Ã¡Å¡ka)
close by grasping - ğ“˜ğ“µğ“£ğ“°ğ“˜Í˜ (Ã¡Ã°iihtÄ…)
close by pulling - ğ“˜ğ“µğ“£ğ“°ğ“˜Í˜ (Ã¡Ã°iitÄ…)
close by zipping, tying, fastening, or buttoning - ğ“ªğ“µğ“£ğ“©ğ“˜Í˜ (oÃ°Ã­inÄ…)
close on - ğ“˜ğ“¤ğ“˜ğ“®ğ“£Í˜ğ“²ğ“Ÿ (Ã¡kaasÄ¯ce)
close one's eyes - ğ“µğ“¶ğ“¬'ğ“£Í˜ğ“²ğ“Ÿ (Ã°upË€Ã­Ì¨ce)
close suddenly or by striking - ğ“¤ğ“˜ğ“®ğ“£Í˜ğ“²ğ“Ÿ (kaasÃ­Ì¨ce)
closing of a prayer - ğ“¤ğ“˜ğ“¯ğ“Ÿğ“©ğ“˜Í˜ (kaaÅ¡Ã©nÄ…)
cloth - ğ“¡ğ“˜ (hÃ¡a), ğ“¡ğ“˜ğ“®ğ“¤ğ“˜ (haaskÃ¡)
clothe oneself with - ğ“£ğ“·ğ“Ÿğ“¤ğ“£ğ“§ğ“£Í˜ (Ã­wehkilÄ¯)
clothes - ğ“¡ğ“˜ğ“®ğ“¤ğ“˜ (haaskÃ¡), ğ“ªğ“¤ğ“¶ğ“§ğ“˜Í˜ (ohkÃºlÄ…), ğ“·ğ“Ÿğ“¤ğ“£ğ“§ğ“£Í˜ (wÃ©hkilÄ¯)
clothes: Osage ~ - ğ“·ğ“˜ğ“»ğ“˜ğ“»ğ“Ÿ ğ“·ğ“Ÿğ“¤ğ“£ğ“§ğ“£Í˜ (waÅ¾Ã¡Å¾e wÃ©hkilÄ¯)
clothes: put on ~(one's own) - ğ“·ğ“Ÿğ“¤ğ“£ğ“§ğ“£Í˜ ğ“ªğ“¤ğ“£ğ“¬ğ“˜ğ“¡ğ“˜Í˜ (wÃ©hkilÄ¯ okÃ­hpaahÄ…)
clothes: put ~ on oneself - ğ“ªğ“¤ğ“£ğ“ªğ“§ğ“˜Ì¨ (Ã³hkioolÃ¡Ì¨)
clothes: take ~ off (another person or oneself) - ğ“µğ“¶ğ“¯ğ“˜ğ“·ğ“˜ (Ã°uuÅ¡Ã¡wa)
clothes: wash ~ - ğ“·ğ“˜ğ“®ğ“£ğ“¯ğ“¤ğ“£ (wasÃ­iÅ¡ki)
clothes: wash ~ for oneself - ğ“¤ğ“£ğ“§ğ“£ğ“¯ğ“¤ğ“£ (hkilÃ­iÅ¡ki)
clothing - ğ“¡ğ“˜ğ“®ğ“¤ğ“˜ (haaskÃ¡)
clothing: any item of ~ - ğ“·ğ“Ÿğ“¤ğ“£ğ“§ğ“£Í˜ (wÃ©hkilÄ¯)
clothing: relieve s.o - ğ“ªf ~ ğ“µğ“¶ğ“¯ğ“°ğ“˜ğ“¤ğ“Ÿ (of ~ Ã°uuÅ¡tÃ¡ke)
cloud, cloudy - ğ“¨ğ“˜Ì¨ğ“¸ğ“¬ğ“¶ (mÃ¡Ì¨xpu)
clown - ğ“·ğ“˜ğ“µğ“£ğ“¡ğ“ªğ“¡ğ“ªğ“°ğ“˜ (waÃ°Ã­hohota), ğ“·ğ“˜ğ“¡ğ“ªğ“¡ğ“ªğ“°ğ“˜ (wahÃ³hota)
clubs (suit in a deck of cards) - ğ“²'ğ“˜ğ“»ğ“£ (cË€Ã¡aÅ¾i)
coat - ğ“˜ğ“¤ğ“˜ğ“¡ğ“˜ğ“¨ğ“£Í˜ (Ã¡kahamÄ¯), ğ“¨ğ“ªÍ˜ğ“¤ğ“˜ğ“¬ğ“ª (mÇ«kÃ¡po), ğ“·ğ“Ÿğ“¤ğ“£ğ“§ğ“£Í˜ (wÃ©hkilÄ¯)
coax someone to say or do s.t - ğ“ªğ“»ğ“£ğ“»ğ“£ğ“Ÿ (oÅ¾Ã­Å¾ie)
cobbler - ğ“¡ğ“ªÍ˜ğ“¬ğ“Ÿğ“¤ğ“˜ğ“¹ğ“Ÿ (hÇ«ÌÇ«pekaaÉ£e)
cock: turkey ~ - ğ“˜ğ“¡ğ“¶ ğ“¨ğ“˜Ì¨ğ“µğ“£Í˜ (Ã¡ahu mÃ¡Ì¨Ã°Ä¯)
cockleburs - ğ“·ğ“˜ğ“¸ğ“˜ğ“¤ğ“˜ (waxÃ¡ka)
coffee - ğ“¨ğ“˜Í˜ğ“¤ğ“˜ğ“®ğ“˜ (mÄ…hkÃ¡sa)
coffer - ğ“»ğ“˜Í˜ğ“¤ğ“ªğ“¤ğ“Ÿ (Å¾Ã¡Ì¨Ä…hkoke)
coffin - ğ“ªğ“¸ğ“Ÿ ğ“®ğ“˜ğ“¬ğ“Ÿ (Ã³xe sÃ¡pe)
coin - ğ“¨ğ“˜Í˜ğ“ºğ“Ÿğ“®ğ“¤ğ“˜ (mÄ…Ìzeska)
coins - ğ“¨Ìğ“˜Í˜ğ“ºğ“Ÿğ“®ğ“¤ğ“˜ ğ“ºğ“£ (mÌÄ…Ìzeska zÃ­), ğ“ªğ“¯ğ“¬ğ“Ÿğ“»ğ“£Í˜ (oÅ¡pÃ©Å¾Ä¯), ğ“·ğ“˜ğ“µğ“˜ğ“·ğ“˜ğ“»ğ“£ (waÃ°Ã¡awaÅ¾i)
cold - ğ“©ğ“£ğ“©ğ“£ (nÃ­ni)
cold: be or fell ~ - ğ“©ğ“£ğ“²ğ“Ÿ (nÃ­hce)
cold: have a ~ - ğ“¡ğ“ªğ“¸ğ“¬ğ“Ÿ ğ“ªÍ˜ (hÃ³xpe Ç«ÌÇ«)
cold (used of weather) - ğ“©ğ“£ğ“·ğ“˜ğ“²ğ“Ÿ (nÃ­wahce)
cold with sniffles and fever (noun) - ğ“¡ğ“ªğ“¸ğ“¬ğ“Ÿ (hÃ³xpe)
collect together (many small scattered things) - ğ“¬ğ“˜ğ“¡ğ“£ (paahÃ­)
colon - ğ“¯ğ“¶ğ“¬ğ“Ÿ (Å¡Ãºpe)
color bright colors - ğ“¡ğ“£Í˜ (hÃ­Ì¨Ä¯)
Comanche (tribe or tribal member) - ğ“¬ğ“˜ ğ“°ğ“ªğ“¤ğ“˜ (hpÃ¡ tÃ³ohka), ğ“·ğ“˜ğ“°ğ“ªğ“¤ğ“˜ (wÃ¡toohka)
comb (noun) - ğ“¬ğ“˜ğ“¡ğ“¶ğ“ºğ“Ÿ (hpahÃºze), ğ“·ğ“Ÿğ“¤ğ“˜ğ“¬ğ“¯ğ“Ÿ (wÃ©kaapÅ¡e)
comb one's hair - ğ“¤ğ“˜ğ“¬ğ“¯ğ“Ÿ (kÃ¡apÅ¡e)
comb someone's hair - ğ“¤ğ“£ğ“¬ğ“¯ğ“Ÿ (kÃ­pÅ¡e)
come back - ğ“˜ğ“§ğ“£ (alÃ­)
come back here (motion underway) - ğ“˜ğ“¤ğ“¶ (akÃº)
come back with something - ğ“°ğ“¡ğ“˜ğ“° bğ“Ÿğ“§ğ“ªğ“©gğ“® ğ“°ğ“ª ğ“ªğ“©ğ“Ÿğ“®ğ“Ÿğ“§f ğ“˜ğ“§ğ“˜ğ“µğ“£Í˜ğ“¤ğ“¶ (that belongs to oneself alÃ¡Ã°Ä¯ku)
come by (i.e, pass) - ğ“£ğ“¬ğ“¯ğ“Ÿ (Ã­pÅ¡e)
come by (i.e -  (), ğ“®ğ“°ğ“ªğ“¬ ğ“£ğ“©) ğ“˜ğ“¡ğ“£ (stop in) ahÃ­)
come here: cause to ~ - ğ“¡ğ“¶ğ“µğ“Ÿ (hÃºÃ°e)
come here (motion accomplished) - ğ“˜ğ“²ğ“£ (achÃ­)
come here (motion underway) - ğ“˜ğ“¡ğ“¶ (ahÃº)
come here with - ğ“˜ğ“¤ğ“¶ (akÃº)
come home (motion underway) - ğ“˜ğ“¤ğ“¶ (akÃº)
come into possesion of - ğ“ªğ“¤ğ“¯ğ“Ÿğ“°ğ“˜Í˜ (okÅ¡ehtÄ…)
come there (motion accomplished) - ğ“˜ğ“¡ğ“£ (ahÃ­)
come to (after being unconscious)come to one's senses - ğ“¤ğ“£ğ“§ğ“˜ğ“ºğ“ª (hkilÃ¡zo), ğ“£ğ“¤ğ“£ğ“µğ“Ÿ (iihkÃ­Ã°e)
comfort - ğ“¤ğ“£ğ“¹ğ“¶ğ“¤ğ“Ÿ (kiÉ£Ãºhke)
comfortable - ğ“¤ğ“£ğ“¤'ğ“˜Í˜ğ“ºğ“Ÿ (hkikË€Ä…ze)
comfortable: make oneself ~ - ğ“¤ğ“£ğ“¤'ğ“˜Í˜ğ“ºğ“Ÿ (hkikË€Ä…Ìze)
comforting - ğ“¯ğ“°ğ“˜ğ“¤ğ“Ÿ (Å¡tÃ¡ke)
comical - ğ“·ğ“˜ğ“¡ğ“ªğ“¡ğ“ªğ“°ğ“˜ (wahÃ³hota), ğ“·ğ“˜ğ“¡ğ“ªğ“°ğ“˜ (wahÃ³ta)
comical person - ğ“·ğ“˜ğ“¡ğ“ªğ“¡ğ“ªğ“°ğ“˜ (wahÃ³hota)
command someone to do something - ğ“˜ğ“¤ğ“˜ğ“»ğ“£ (Ã¡kaaÅ¾i), ğ“¤ğ“˜ğ“»ğ“£ (kaaÅ¾Ã­)
commit suicide - ğ“²'ğ“Ÿğ“¤ğ“£ğ“µğ“Ÿ (cË€Ã©hkiÃ°e)
committeeman - ğ“°ğ“ªğ“°ğ“˜Ì¨ğ“¡ğ“˜ (totÃ¡Ì¨ha)
compete with one another - ğ“˜ğ“¤ğ“£ğ“¤ğ“£ğ“Ÿ (Ã¡hkihkie)
complementizer - ğ“²ğ“Ÿ (che)
complete - ğ“œğ“ªğ“¤ğ“˜ (brÃ³ka)
compress - ğ“¤ğ“˜ğ“®ğ“¤ğ“£ (kaaskÃ­)
conceal, conceal oneself - ğ“©ğ“˜Í˜ğ“§ğ“ªÍ˜ğ“¡ğ“˜ (nÄ…lÃ³Ì¨Ç«ha), ğ“¬ğ“¶ğ“®ğ“¬ğ“Ÿ (pÃºuspe)
conceited: be ~ - ğ“ªğ“»ğ“ª ğ“˜ğ“¤ğ“£ğ“»ğ“£Í˜ (Ã³Å¾o Ã¡hkiÅ¾Ä¯)
concenr: feel ~ over, be ~ed about - ğ“ªğ“µğ“˜Í˜ğ“²ğ“Ÿğ“¯ğ“£ (Ã³Ã°Ä…Ä…ceÅ¡i)
conduct one's own or someone else's affairs - ğ“ªğ“µğ“ªğ“·ğ“˜ğ“µğ“Ÿ (oÃ°Ã³waÃ°e)
conduct oneself - ğ“˜ğ“¤ğ“£ğ“§ğ“˜ğ“µğ“£Í˜ (ahkÃ­laÃ°Ä¯)
conference held by a group of people - ğ“¤ğ“£ğ“®ğ“°ğ“ª (hkiistÃ³)
confused: be ~ - ğ“˜ğ“»ğ“˜Í˜ğ“£Í˜ ğ“µğ“¶ğ“²'ğ“˜ğ“¤ğ“Ÿ (Ã¡Å¾Ä…Ä¯ Ã°uucË€Ã¡ke)
confused, confused person - ğ“¬ğ“¸ğ“˜ğ“µğ“˜ğ“»ğ“£ (pxÃ¡Ã°aÅ¾i)
congested - ğ“ªğ“²'ğ“£Í˜ğ“ºğ“Ÿ (ocË€Ã­Ì¨ze)
congressional representative - ğ“¤ğ“£ğ“®ğ“°ğ“ª ğ“ªğ“¨ğ“˜Í˜ğ“µğ“£Í˜ (hkiistÃ³ omÄ…Ã°Ä¯)
congressman, congresswoman - ğ“·ğ“˜ğ“¤ğ“£ğ“§ğ“˜ğ“²ğ“Ÿ ğ“¤ğ“˜ğ“¹ğ“Ÿ (wahkÃ­laace kÃ¡aÉ£e)
conquer - ğ“ªğ“¡ğ“£ (ohÃ­)
consciousness: regain ~ - ğ“£ğ“¤ğ“£ğ“µğ“Ÿ (iihkÃ­Ã°e)
consecrated - ğ“¸ğ“ªğ“¬ğ“Ÿ (xÃ³pe)
consecutively - ğ“ªğ“¤ğ“£ğ“Ÿğ“°ğ“¸ğ“˜Í˜ğ“°ğ“¸ğ“˜Í˜ (ohkÃ­etxÄ…txÄ…)
consider - ğ“˜ğ“·ğ“˜ğ“µğ“£ğ“§ğ“˜Í˜ (Ã¡waÃ°ilÄ…), ğ“Ÿğ“µğ“Ÿ (Ã©Ã°e), ğ“Ÿğ“¤ğ“£ğ“µğ“Ÿ (Ã©kiÃ°e), ğ“£ğ“µğ“£ğ“§ğ“˜Í˜ (Ã­Ã°ilÄ…), ğ“·ğ“˜ğ“µğ“£ğ“§ğ“˜Í˜ (waÃ°Ã­lÄ…)
consider precious - ğ“ªğ“¸ğ“°ğ“˜ ğ“¤ğ“˜ğ“¹ğ“Ÿ (Ã³xta kÃ¡aÉ£e)
consider something - ğ“°ğ“˜ğ“°ğ“˜Í˜ ğ“£ğ“µğ“£ğ“§ğ“˜Í˜ (tÃ¡atÄ… Ã­Ã°ilÄ…)
consommÃ© - ğ“°ğ“˜ğ“©ğ“£ (htaanÃ­i)
constantly - ğ“¯ğ“°ğ“˜Í˜ (Å¡tÄ…)
consume - ğ“µğ“˜ğ“©ğ“£Í˜ (Ã°aanÃ­Ì¨Ä¯)
consumption (tuberculosis) - ğ“¨ğ“˜Í˜ğ“¤ğ“Ÿ ğ“©ğ“£ (mÃ¡Ì¨Ä…ke nÃ­), ğ“¨ğ“˜Í˜ğ“¤ğ“Ÿ ğ“¬ğ“¶ğ“ºğ“Ÿ (mÃ¡Ì¨Ä…ke pÃºze)
contact: bring components into ~(e.g., parts of a blanket) - ğ“µğ“£ğ“®ğ“¤ğ“£ğ“¤ğ“Ÿ (Ã°iiskÃ­ke)
container - ğ“ªğ“»ğ“¶ (ooÅ¾Ãº), ğ“ªğ“»ğ“¶ (Ã³oÅ¾u)
contaminate (e.g., water on air) - ğ“£ğ“ºğ“£ğ“ºğ“£ğ“¤ğ“Ÿ ğ“¤ğ“˜ğ“¹ğ“Ÿ (Ã­zizike kÃ¡aÉ£e)
contempt: hold someone in ~ - ğ“¬ğ“£ğ“»ğ“£ ğ“˜ğ“»ğ“£Í˜ (hpÃ­iÅ¾i aÅ¾Ã­Ì¨)
contemptible - ğ“£ğ“®ğ“Ÿğ“·ğ“˜ğ“µğ“Ÿ (iisÃ©waÃ°e)
contend with one another - ğ“˜ğ“¤ğ“£ğ“¤ğ“£ğ“Ÿ (Ã¡hkihkie)
content (happy) - ğ“¯ğ“¤ğ“˜ğ“¯ğ“¤ğ“˜ğ“µğ“˜ (Å¡kaÅ¡kÃ¡Ã°a)
contest (verb) - ğ“˜ğ“¤ğ“£ğ“¤ğ“£ğ“Ÿ (Ã¡hkihkie)
continally - ğ“¡ğ“˜ğ“²ğ“£ (hÃ¡achi), ğ“©ğ“˜Í˜ (nÄ…), ğ“©ğ“˜Í˜ğ“©ğ“˜Í˜ ğ“¯ğ“ªÍ˜ (nÄ…nÄ… Å¡Ç«), ğ“¯ğ“°ğ“˜Í˜ (Å¡tÄ…)
continuative aspect markers - ğ“˜ğ“¤ğ“¸ğ“˜ (akxa), ğ“˜ğ“¬ğ“˜ (apa), ğ“˜Í˜ğ“µğ“Ÿ (Ä…Ã°Ã©), ğ“˜Í˜ğ“µğ“£Í˜ğ“¡ğ“Ÿ (Ä…Ã°Ä¯hÃ©), ğ“˜Í˜ğ“µğ“£Í˜ğ“¤ğ“¯ğ“Ÿ (Ä…Ã°Ä¯kÅ¡Ã©), ğ“˜Í˜ğ“¡ğ“Ÿ (Ä…hÃ©), ğ“˜Í˜ğ“¤ğ“˜ğ“µğ“Ÿ (Ä…kÃ¡Ã°e), ğ“˜Í˜ğ“¤ğ“˜ğ“°ğ“¸ğ“˜Ì¨ (Ä…katxÃ¡Ì¨), ğ“˜Í˜ğ“°ğ“¸ğ“˜Ì¨ (Ä…txÃ¡Ì¨), ğ“˜Í˜ğ“°ğ“¸ğ“˜Í˜ğ“¡ğ“Ÿ (Ä…txÄ…hÃ©), ğ“µğ“šğ“¯ğ“Ÿ (Ã°aÄ¯Å¡Ã©), ğ“µğ“˜ğ“°ğ“¸ğ“˜Ì¨ğ“¯ğ“Ÿ (Ã°atxÃ¡Ì¨Å¡e), ğ“£Í˜ğ“¤ğ“¯ğ“Ÿ (Ä¯kÅ¡Ã©), ğ“¤ğ“¯ğ“Ÿ (kÅ¡e), ğ“¨ğ“£Í˜ğ“¤ğ“¯ğ“Ÿ (mÄ¯kÅ¡Ã©), ğ“©ğ“˜Í˜ğ“¤ğ“¸ğ“˜ğ“¯ğ“Ÿ (nÄ…kxÃ¡Å¡e), ğ“©ğ“£Í˜ğ“¤ğ“¯ğ“Ÿ (nÄ¯kÅ¡Ã©), ğ“¬ğ“˜ğ“¯ğ“Ÿ (paaÅ¡Ã©), ğ“¬ğ“˜ğ“£ (pai), ğ“°ğ“¸ğ“˜Í˜ (txÄ…), ğ“»ğ“˜Ì¨ğ“¤ğ“¯ğ“Ÿ (Å¾Ã¡Ì¨kÅ¡e)
continue - ğ“¯ğ“¤ğ“˜Ì¨ (Å¡kÃ¡Ì¨)
continue, continue to - ğ“¯ğ“£ğ“©ğ“˜Í˜ (Å¡inÄ…), ğ“¯ğ“ªÍ˜ (Å¡Ç«)
continuously - ğ“¯ğ“°ğ“˜Í˜ (Å¡tÄ…)
contrarily - ğ“ªğ“µğ“˜Í˜ğ“»ğ“£ (Ã³Ã°Ä…Å¾i)
contrary: go or be ~ to - ğ“˜ğ“µğ“£ğ“°ğ“˜ (Ã¡Ã°ihta)
converse, converse with - ğ“ªğ“¤ğ“£ğ“Ÿ (ohkÃ­e)
converse with each other - ğ“ªğ“¤ğ“£ğ“¤ğ“£ğ“Ÿ (ohkÃ­hkie)
convince - ğ“ªğ“»ğ“£ğ“»ğ“£ğ“Ÿ (oÅ¾Ã­Å¾ie)
cook (noun, verb) - ğ“ªğ“¡ğ“ªÍ˜ (oohÃ³Ì¨)
cook, cook outside (refers only to cooking meat on a rack, as for barbecue) - ğ“ªğ“¤ğ“˜ğ“²ğ“Ÿ (Ã³hkace)
cook for oneself - ğ“ªğ“¤ğ“£ğ“¡ğ“˜Í˜ (Ã³ohkihÄ…)
cook things, cook stuff - ğ“ªğ“¡ğ“ªÍ˜ (Ã³ohÇ«)
cook together - ğ“ªğ“µğ“ªğ“¤ğ“£ğ“¡ğ“˜Í˜ (oÃ°Ã³hkihÄ…)
cooked - ğ“²ğ“¶ğ“²ğ“Ÿ (cÃºuce)
cookhouse - ğ“ªğ“¡ğ“ªÍ˜ğ“²ğ“£ (oohÇ«Ìhci)
cookie - ğ“·ğ“˜ğ“®ğ“¤ğ“¶ğ“Ÿğ“»ğ“£Í˜ (waskÃºeÅ¾Ä¯)
cooking: add in ~ - ğ“ªğ“µğ“ªğ“¤ğ“£ğ“¡ğ“˜Í˜ (oÃ°Ã³hkihÄ…)
cooking pot - ğ“ªğ“¡ğ“ªÍ˜ (Ã³ohÇ«)
cooking utensils - ğ“·ğ“Ÿğ“ªğ“¡ğ“ªÍ˜ (wÃ©oohÇ«), ğ“·ğ“£ğ“ªğ“¡ğ“ªÍ˜ (wiÃ³ohÇ«)
cookstove - ğ“¨ğ“˜Ì¨ğ“ºğ“Ÿğ“·ğ“Ÿğ“ªğ“¡ğ“ªÍ˜ (mÃ¡Ì¨zewÃ©oohÇ«)
cool (as weather), cool to the touch - ğ“©ğ“£ğ“©ğ“£ (nÃ­ni)
coon (raccoon) - ğ“¨ğ“£Í˜ğ“¤ğ“˜ (mÃ­Ì¨hkaa)
copperhead - ğ“˜ğ“£Í˜ğ“¬ğ“˜ğ“¸ğ“ª (aÃ­Ì¨paxo)
copulate - ğ“·ğ“˜ğ“²ğ“¶ (wachÃº)
copulate with - ğ“˜ğ“µğ“£Í˜ğ“˜ğ“»ğ“˜Í˜ (aÃ°Ã­Ì¨aÅ¾Ä…), ğ“²ğ“¶ğ“Ÿ (chÃºe)
cord - ğ“·ğ“Ÿğ“µğ“£Í˜ (wÃ©Ã°Ä¯)
cork, fishing cork - ğ“·ğ“£ğ“ªğ“µğ“˜ğ“®ğ“¬ğ“Ÿ (wÃ­oÃ°aaspe)
corn - ğ“¡ğ“˜ğ“¬ğ“˜ (hÃ¡pa)
corn: cracked ~ - ğ“¡ğ“˜ğ“¬ğ“˜ ğ“·ğ“˜ğ“§ğ“Ÿğ“¤ğ“Ÿ (hÃ¡pa walÃ©ke)
corn: cut ~ (fresh corn cut off the cob) - ğ“¬ğ“˜ğ“¯ğ“¬ğ“¶ (paaÅ¡pÃº)
corn: dried ~ - ğ“ªğ“¡ğ“ªÍ˜ ğ“®ğ“˜ğ“¤ğ“£ (Ã³ohÇ« saakÃ­), ğ“·ğ“˜ğ“°ğ“¸ğ“˜ğ“ºğ“¶ (watxÃ¡zu)
corn: fresh ~ - ğ“¡ğ“˜ğ“¬ğ“˜ (hÃ¡pa), ğ“¡ğ“˜ğ“¬ğ“˜ ğ“·ğ“˜ğ“²'ğ“Ÿğ“¤ğ“˜ (hÃ¡pa wacË€Ã©ka)
corn: fresh ~ cut off the cob - ğ“¬ğ“˜ğ“¯ğ“¬ğ“¶ (paaÅ¡pÃº)
corn: grated fresh ~ baked in oven - ğ“·ğ“˜ğ“²ğ“¶ğ“Ÿ ğ“»ğ“Ÿğ“§ğ“˜ (wacÃºe Å¾Ã©ela)
corn: ripe ~ (just at the point of ripeness) - ğ“¡ğ“˜ğ“¬ğ“˜ ğ“·ğ“˜ğ“®ğ“¶ğ“°ğ“˜ (hÃ¡pa wasÃºta)
corn: squaw ~ (white term) - ğ“¡ğ“˜ğ“¬ğ“˜ ğ“·ğ“˜ğ“²'ğ“Ÿğ“¤ğ“˜ (hÃ¡pa wacË€Ã©ka)
corn husk - ğ“·ğ“˜ğ“²ğ“¶ğ“Ÿğ“¸ğ“˜Í˜ (wacÃºexÄ…)
cornbread - ğ“¡ğ“˜ğ“¬ğ“˜ ğ“·ğ“˜ğ“²ğ“¶ğ“Ÿ (hÃ¡pa wacÃºe), ğ“·ğ“˜ğ“²ğ“¶ğ“Ÿ ğ“»ğ“Ÿğ“§ğ“˜ (wacÃºe Å¾Ã©ela), ğ“·ğ“˜ğ“²ğ“¶ğ“Ÿğ“¯ğ“°ğ“ªÍ˜ (wacÃºeÅ¡tÇ«)
corner - ğ“¬ğ“˜ğ“¹ğ“ª (paaÉ£Ã³)
cornmeal dumplings - ğ“·ğ“˜ğ“²ğ“¶ğ“Ÿ ğ“¤ğ“˜ğ“®ğ“¤ğ“£ (wacÃºe kaaskÃ­)
cornshuck - ğ“·ğ“˜ğ“²ğ“¶ğ“Ÿğ“¸ğ“˜Í˜ (wacÃºexÄ…)
correct, correctly - ğ“Ÿğ“¤ğ“ªÍ˜ (Ã©kÇ«)
correctly: say something ~ - ğ“Ÿğ“¤ğ“ªÍ˜ ğ“µğ“˜ğ“²ğ“Ÿ (Ã©kÇ« Ã°aacÃ©)
cosmetics - ğ“¤ğ“£ğ“¤'ğ“ªÍ˜ (kikË€Ç«Ì)
costume - ğ“·ğ“Ÿğ“¤ğ“£ğ“§ğ“£Í˜ (wÃ©hkilÄ¯)
cot: small ~ - ğ“˜ğ“»ğ“˜Í˜ğ“»ğ“£Í˜ (Ã¡Å¾Ä…Å¾Ä¯)
cottonwood - ğ“¬ğ“˜ğ“¤'ğ“˜ (pÃ¡akË€a), ğ“»ğ“˜Í˜ ğ“¤'ğ“˜ (Å¾Ã¡Ì¨Ä… kË€a)
couch - ğ“˜ğ“§ğ“£Í˜ğ“®ğ“²ğ“Ÿ (Ã¡lÄ¯Ä¯scee), ğ“˜ğ“»ğ“˜Í˜ (Ã¡Å¾Ä…), ğ“ªğ“»ğ“˜Í˜ (Ã³Å¾Ä…)
cough (N and V) - ğ“¡ğ“ªğ“¸ğ“¬ğ“Ÿ (hÃ³xpe)
cough: have or be suffering from a ~ - ğ“¡ğ“ªğ“¸ğ“¬ğ“Ÿ ğ“ªÍ˜ (hÃ³xpe Ã³Ì¨Ç«)
could - ğ“µğ“˜Í˜ğ“²ğ“Ÿ (Ã°Ä…Ä…chÃ©)
council - ğ“ªğ“¤ğ“£ğ“¬ğ“˜ ğ“²ğ“Ÿ (ohkÃ­hpa che)
council house - ğ“¤ğ“£ğ“®ğ“°ğ“ªğ“²ğ“£ (hkiistÃ³hci), ğ“¤ğ“£ğ“®ğ“°ğ“ªğ“²ğ“£ (kiistohcÃ­)
council meeting - ğ“¤ğ“£ğ“®ğ“°ğ“ª (hkiistÃ³)
council member - ğ“¤ğ“£ğ“®ğ“°ğ“ª ğ“ªğ“¨ğ“˜Í˜ğ“µğ“£Í˜ (hkiistÃ³ omÄ…Ã°Ä¯)
council session: tribal ~ - ğ“¤ğ“£ğ“®ğ“°ğ“ª (hkiistÃ³)
count (verb) - ğ“µğ“˜ğ“·ğ“˜ (Ã°aawÃ¡), ğ“·ğ“˜ğ“µğ“˜ğ“·ğ“˜ (waÃ°Ã¡awa)
count on - ğ“£ğ“¤ğ“£ğ“©ğ“˜ğ“»ğ“£ (Ã­kinaaÅ¾i)
count oneself - ğ“¤ğ“£ğ“§ğ“˜ğ“·ğ“˜ (hkilÃ¡awa)
count out - ğ“µğ“˜ğ“·ğ“˜ (Ã°aawÃ¡)
counting - ğ“·ğ“˜ğ“µğ“˜ğ“·ğ“˜ (waÃ°Ã¡awa)
country (land) - ğ“¨ğ“˜Ì¨ğ“»ğ“˜Í˜ (mÃ¡Ì¨Å¾Ä…)
country (nation?) - ğ“©ğ“£ğ“¤ğ“˜ğ“¯ğ“£ğ“¤ğ“˜ ğ“ªğ“²ğ“£ (nÃ­hkaÅ¡ika ochÃ­)
country (rural area) - ğ“ºğ“˜Í˜ (zÃ¡Ì¨Ä…), ğ“ºğ“˜Í˜ğ“²ğ“Ÿ (zÃ¡Ì¨Ä…ce)
countryside - ğ“¨ğ“˜ğ“»ğ“˜Í˜ (mÃ¡Å¾Ä…), ğ“¨ğ“˜Í˜ğ“»ğ“˜Ì¨ğ“°ğ“˜Í˜ (mÄ…Å¾Ã¡Ì¨htÄ…), ğ“ºğ“˜Í˜ (zÃ¡Ì¨Ä…), ğ“ºğ“˜Í˜ğ“²ğ“Ÿ (zÃ¡Ì¨Ä…ce)
couple, pair, two of them - ğ“©ğ“˜ğ“¤ğ“ªÍ˜ğ“£Í˜ (nahkÇ«Ã­Ì¨)
courageous - ğ“·ğ“˜ğ“¯ğ“ªğ“¯ğ“Ÿ (waÅ¡Ã³Å¡e)
court (woo) - ğ“µğ“£ğ“§ğ“˜Í˜ (Ã°Ã­lÄ…)
courthouse - ğ“¤ğ“£ğ“®ğ“°ğ“ªğ“²ğ“£ (hkiistÃ³hci)
courtship: be in a ~ with - ğ“»ğ“ªÌğ“§ğ“Ÿ (Å¾oÌle)
cousin: male ~ (specifically, father's sister's son) -  ()
" my/your/his/her father's sister's son" - ğ“²ğ“£ğ“ªğ“¯ğ“¤ğ“˜ (hciÃ³Å¡ka)
"my father's sister's son" - ğ“·ğ“£ğ“²ğ“ªğ“¯ğ“¤ğ“˜ (wihcÃ³Å¡ka)
"his/her father's sister's son" - ğ“£ğ“²ğ“ªğ“¯ğ“¤ğ“˜ (ihcÃ³Å¡ka)
cousin: female ~(specifically, father's sister's daughter) -  ()
"my father's sister's daughter" - ğ“·ğ“£ğ“²ğ“£ğ“»ğ“ª (wihcÃ­Å¾o)
"your father's sister's daughter" - ğ“µğ“£ğ“²ğ“£ğ“»ğ“ª (Ã°ihcÃ­Å¾o)
"his father's sister's daughter" - ğ“£ğ“²ğ“£ğ“»ğ“ª (ihcÃ­Å¾o)
cover: pull or tug something over in order to ~ - ğ“˜ğ“µğ“¶ğ“ºğ“¶ (Ã¡Ã°uzu)
cover (for a tipi, sweat lodge, pillow, etc.) - ğ“ªğ“µğ“£ğ“¯ğ“£ (oÃ°Ã­Å¡i)
cover oneself up - ğ“˜ğ“¤ğ“£ğ“¤ğ“˜ğ“®ğ“¬ğ“Ÿ (Ã¡hkihkaaspe)
cover over, cover up - ğ“˜ğ“¤ğ“˜ğ“®ğ“¬ğ“Ÿ (Ã¡kaaspe)
cover over by spreading some material upon - ğ“˜ğ“¤ğ“˜ğ“¹ğ“˜ğ“²ğ“Ÿ (Ã¡kaaÉ£ace)
cover with earth - ğ“˜ÌŒğ“µğ“£ğ“¤'ğ“ª (aÌŒÃ°ikË€o)
covered with: be ~(as a garment) - ğ“£Í˜ (Ã­Ì¨)
covering (e.g., a windowshade) - ğ“˜ğ“¤ğ“˜ğ“®ğ“¬ğ“Ÿ (akÃ¡aspe)
covering wrapped around something - ğ“˜ğ“¬ğ“Ÿğ“°ğ“¸ğ“˜ (Ã¡petxa)
covert, covertly - ğ“©ğ“˜Í˜ğ“§ğ“ªÍ˜ğ“¡ğ“˜ (nÄ…lÇ«ÌÇ«ha)
cow - ğ“²ğ“Ÿğ“®ğ“¤ğ“˜ (hcÃ©eska), ğ“²ğ“Ÿğ“®ğ“¤ğ“˜ ğ“¨ğ“£Í˜Ìğ“£Í˜ğ“¤ğ“˜ (hceeskÃ¡ mÄ¯ÌÄ¯ka)
coyote - ğ“¯ğ“ªÍ˜ğ“¨ğ“£Í˜ğ“¤ğ“˜ğ“®ğ“Ÿ (Å¡Ã³Ì¨mÄ¯hkase)
crack (intr.) - ğ“¤ğ“˜ğ“§ğ“Ÿğ“¤ğ“Ÿ (kaalÃ©ke)
crack from sudden impact - ğ“¤ğ“˜ğ“¸ğ“¶ğ“¹ğ“Ÿ (kaaxÃºÉ£e)
crackers. - ğ“·ğ“˜ğ“²ğ“¶ğ“Ÿ ğ“¸ğ“¶ğ“¹ğ“˜ (wacÃºe xÃºÉ£a)
cradle of any type, cradleboard. - ğ“ªğ“µğ“ªğ“¬ğ“¯ğ“Ÿ (oÃ°Ã³pÅ¡e)
crafts: small ~. - ğ“¡ğ“£Í˜ğ“²ğ“Ÿğ“»ğ“£Í˜ (hÄ¯Ä¯cÃ©Å¾Ä¯)
cranky. - ğ“ªğ“¤'ğ“˜Í˜ ğ“¬ğ“£ğ“»ğ“£ (Ã³kË€Ä… hpÃ­iÅ¾i), ğ“·ğ“˜ğ“µğ“£ğ“§ğ“˜Í˜Â ğ“˜ğ“¯ğ“¤ğ“˜ (waÃ°Ã­lÄ…Â Ã¡Å¡ka)
cranky: feel ~. - ğ“¤ğ“£ğ“»ğ“£Í˜ (hkÃ­Å¾Ä¯)
crash (verb). - ğ“¤ğ“˜ğ“¬ğ“¸ğ“ªğ“¤ğ“Ÿ (kaapxÃ³hke)
crave. - ğ“¤ğ“ªÍ˜ğ“µğ“˜ (kÃ³Ì¨Ã°a)
crawl on, crawl upon. - ğ“˜ğ“¨ğ“£Í˜ğ“²ğ“Ÿ (Ã¡mÄ¯ce)
crazed with medicine. - ğ“¨ğ“˜Ì¨ğ“¤ğ“˜ğ“»ğ“ªğ“£ğ“¤ğ“˜ (mÃ¡Ì¨hkaÅ¾Ã³ika)
crazy. - ğ“²'ğ“Ÿğ“¤ğ“˜ (cË€Ã©ka)
crazy, crazily. - ğ“Ÿğ“¤ğ“ªÍ˜ğ“£Í˜ğ“¤ğ“Ÿ (ekÃ³Ì¨Ä¯ke)
crazy person. - ğ“·ğ“˜ğ“µğ“£ğ“§ğ“˜Í˜ ğ“Ÿğ“¤ğ“ªÍ˜ ğ“£Í˜ğ“¤ğ“Ÿ (waÃ°Ã­lÄ… eekÃ³Ì¨ Ä¯kÃ©)
cream. - ğ“¬ğ“˜ğ“ºğ“Ÿğ“©ğ“£ ğ“·ğ“Ÿğ“§ğ“£ (paazÃ©nii wÃ©li)
cream (for applying to a surface to make it smooth). - ğ“®ğ“°ğ“˜ğ“µğ“Ÿ (stÃ¡Ã°e)
creek. - ğ“¤ğ“˜ğ“¸ğ“˜ (kÃ¡xa)
creek: small ~. - ğ“¤ğ“˜ğ“¸ğ“˜ ğ“»ğ“£Í˜ (kÃ¡xa Å¾Ä¯)
Creek Indians. - ğ“¨ğ“¶ğ“®ğ“¤ğ“ªğ“¤ğ“Ÿ (muskÃ³ke)
crescent moon. - ğ“¨ğ“£Í˜ğ“ªÍ˜ğ“¬ğ“˜ ğ“˜ğ“µğ“£ğ“¤ğ“Ÿğ“»ğ“Ÿ (mÃ­Ì¨Ä¯Ç«pa aÃ°ikeÅ¾e)
crestfallen. - ğ“¤ğ“£ğ“ºğ“ªğ“»ğ“£ (kÃ­zoÅ¾i)
cricket. - ğ“°ğ“˜ğ“°ğ“˜ğ“ºğ“Ÿ (htÃ¡htaze)
crier. - ğ“£ğ“Ÿğ“¤ğ“£ğ“Ÿ (Ã­ekie), ğ“·ğ“˜ğ“²ğ“£ğ“¬ğ“¸ğ“š (wacÃ­pxaÄ¯)
Crippled Hawk (personal name). - ğ“»ğ“Ÿğ“¤ğ“˜ğ“¸ğ“ªÍ˜ ğ“§ğ“Ÿğ“°ğ“ªÍ˜ (Å¾ekÃ¡xÇ« letÃ³Ì¨)
crockery. - ğ“¡ğ“£Í˜ğ“²ğ“Ÿ (hÃ­Ì¨Ä¯ce)
crone. - ğ“·ğ“˜ğ“¤'ğ“ªğ“»ğ“£Í˜ (wakË€Ã³Å¾Ä¯)
crooked. - ğ“²'ğ“£Í˜ğ“¯ğ“˜ (cË€Ä¯Å¡a), ğ“¬ğ“˜ğ“²'ğ“£Í˜ (paacË€Ã­Ì¨)
crooked (referring to a human body). - ğ“²'ğ“£Í˜ğ“¸ğ“˜ (cË€Ã­Ì¨xa)
crop: wheat ~. - ğ“·ğ“˜ğ“¬ğ“ªğ“¯ğ“¤ğ“Ÿ ğ“ªğ“·ğ“Ÿ (wapÃ³Å¡ke Ã³we)
cross (adjective). - ğ“ªğ“¤'ğ“˜Í˜ ğ“¬ğ“£ğ“»ğ“£ (Ã³kË€Ä… hpÃ­iÅ¾i)
cross (noun). - ğ“²'ğ“˜ğ“»ğ“£ (cË€Ã¡aÅ¾i)
cross (verb). - ğ“˜ğ“µğ“¶ğ“°ğ“˜ ğ“µğ“Ÿ (Ã¡Ã°uuhta Ã°Ã©e)
crow (noun). - ğ“¤ğ“˜ğ“¹ğ“Ÿ (hkÃ¡É£e)
crowd: help to make a bit of a ~. - ğ“·ğ“Ÿğ“¡ğ“¶ğ“»ğ“£Í˜ (wÃ©huuÅ¾Ä¯)
crowd: make a ~. - ğ“·ğ“Ÿğ“¡ğ“¶ (wÃ©huu), ğ“·ğ“Ÿğ“¡ğ“¶ğ“¤ğ“ªÍ˜ğ“£Í˜ (wÃ©huukÇ«Ä¯)
crowd someone - ğ“ªğ“¤ğ“˜ğ“µğ“£Í˜ğ“¤ğ“Ÿ (ohkÃ¡Ã°Ä¯ke)
crucifix. - ğ“²'ğ“˜ğ“»ğ“£ (cË€Ã¡aÅ¾Ã­)
crumbly: bread that is ~ (i.e., crackers). - ğ“·ğ“˜ğ“²ğ“¶ğ“Ÿ ğ“¸ğ“¶ğ“¹ğ“˜ (wacÃºe xÃºÉ£a)
crutch. - ğ“£ğ“®ğ“˜ (Ã­isa)
cry (intransitive). - ğ“¹ğ“˜ğ“¤ğ“Ÿ (É£aakÃ©)
cry for. - ğ“˜ğ“¹ğ“˜ğ“¤ğ“Ÿ (Ã¡É£aake)
cub (of any species of bear). - ğ“·ğ“˜ğ“®ğ“˜ğ“¬ğ“Ÿğ“»ğ“£Í˜ (wasÃ¡peÅ¾Ä¯)
cucumber. - ğ“¤ğ“ªğ“¤ğ“ªğ“¨ğ“˜ (hkohkÃ³ma)
culmination of. - ğ“ª- (Ã³-)
cunning. - ğ“©ğ“˜Í˜ğ“§ğ“ªÍ˜ğ“¡ğ“˜ (nÄ…lÃ³Ì¨Ç«ha)
cup. - ğ“²ğ“Ÿğ“¡ğ“Ÿğ“®ğ“¤ğ“˜ (hcÃ©heska), ğ“²ğ“Ÿğ“¡ğ“Ÿğ“»ğ“£Í˜ (hcÃ©heÅ¾Ä¯), ğ“¨ğ“˜Í˜ğ“¤ğ“˜ğ“®ğ“˜ğ“£ğ“ªğ“»ğ“¶,ğ“ªğ“»ğ“¶ (mÄ…hkÃ¡saiooÅ¾Ãº,ooÅ¾Ãº)
curb motion. - ğ“ªğ“µğ“£ğ“°ğ“˜Í˜ (oÃ°Ã­itÄ…)
curl (as a person/s hair). - ğ“µğ“¶ğ“¤ğ“£ğ“¤ğ“£Í˜ (Ã°uuhkÃ­hkÄ¯)
curly. - ğ“¤ğ“£ğ“¤ğ“£Í˜ğ“©ğ“£Í˜ (hkÃ­hkÄ¯nÄ¯)
currency (paper). - ğ“°ğ“˜ğ“©ğ“˜Ì¨ğ“¤'ğ“˜ ğ“¨ğ“˜Ì¨ğ“ºğ“Ÿğ“®ğ“¤ğ“˜ (htanÃ¡Ì¨kË€a mÃ¡Ì¨zeska)
curry the mane or coat of an animal. - ğ“¤ğ“˜ğ“¬ğ“¯ğ“Ÿ (kÃ¡apÅ¡e), ğ“¤ğ“£ğ“¬ğ“¯ğ“Ÿ (kÃ­pÅ¡e), ğ“·ğ“˜ğ“¤ğ“˜ğ“¬ğ“¯ğ“Ÿ (wÃ¡kaapÅ¡e)
curse (noun). - ğ“£ğ“Ÿ ğ“¬ğ“£ğ“»ğ“£ (Ã­e hpÃ­iÅ¾i)
curse (verb). - ğ“§ğ“ªÍ˜ (lÃ³Ì¨Ç«)
curse over and over. - ğ“§ğ“ªÍ˜ğ“§ğ“ªÍ˜ (lÃ³Ì¨Ç«lÇ«Ç«)
curse someone - ğ“¤ğ“£ğ“§ğ“˜ğ“»ğ“ªğ“»ğ“£ (hkilÃ¡aÅ¾oÅ¾i), ğ“¤ğ“£ğ“§ğ“ªÍ˜ğ“»ğ“Ÿ (kilÃ³Ì¨Å¾e)
curses. - ğ“£ğ“Ÿ ğ“ªğ“¤ğ“˜ğ“¹ğ“ ğ“¤ğ“Ÿ (Ã­e okaaÉ£Ã©Ä¯ke)
curve (noun). - ğ“¤ğ“ªğ“¯ğ“˜ (koÅ¡a)
curved. - ğ“²'ğ“£Í˜ğ“¯ğ“˜ (cË€Ä¯Å¡a)
curved stick used to play kasini (shinny). - ğ“ªğ“¤ğ“£ğ“²ğ“Ÿ (ohkÃ­ce)
cushion to sit on (as for a sofa, chair, or other seat). - ğ“·ğ“˜ğ“¤ğ“˜ğ“¯ğ“°ğ“ªÍ˜ (wÃ¡kaÅ¡tÇ«)
custom. - ğ“ªğ“¤'ğ“˜Í˜ (Ã³kË€Ä…)
customarily. - ğ“©ğ“˜Í˜ (nÄ…)
cut (adjective). - ğ“»ğ“˜ğ“°ğ“˜ (Å¾Ã¡hta)
cut (noun). - ğ“·ğ“˜ğ“¬ğ“˜ğ“®ğ“Ÿ (wÃ¡paase)
cut (verb). - ğ“¤ğ“˜ğ“®ğ“Ÿ (kaasÃ©), ğ“¬ğ“˜ğ“®ğ“Ÿ (paasÃ©), -ğ“®ğ“Ÿ (-se), ğ“·ğ“˜ğ“¬ğ“˜ğ“®ğ“Ÿ (wÃ¡paase)
cut: one who's things up. - ğ“·ğ“˜ğ“¬ğ“˜ğ“®ğ“Ÿ (wapÃ¡se)
cut (e.g., with an axe, lawnmower, or knife). - ğ“¤ğ“˜ğ“®ğ“Ÿ (kaasÃ©)
cut (e.g., with scissors). - ğ“µğ“¶ğ“®ğ“Ÿ (Ã°uusÃ©)
cut a hole in by pushing. - ğ“ªğ“¬ğ“˜ğ“¤'ğ“ª (opÃ¡kË€o)
cut into pieces (e.g., a cake). - ğ“¬ğ“˜ğ“®ğ“Ÿ (paasÃ©)
cut meat (e.g., slice meat for barbecue). - ğ“·ğ“˜ğ“¤ğ“˜ğ“£ (wakÃ¡i)
cut off. - ğ“¬ğ“˜ğ“®ğ“Ÿ (paasÃ©)
cut something for someone - ğ“¤ğ“£ğ“®ğ“Ÿ (kÃ­se)
cut something with something else by pushing down on the item being cut. - ğ“£ğ“¬ğ“˜ğ“®ğ“Ÿ (Ã­paase)
cut the grass. - ğ“¨ğ“˜Í˜ğ“¡ğ“£Í˜ ğ“¬ğ“˜ğ“®ğ“Ÿ (mÄ…Ä…hÃ­Ì¨ paasÃ©)
cut up (e.g., meat, potatoes). - ğ“¬ğ“˜ğ“®ğ“Ÿ (paasÃ©)
cut up into slices (e.g., bananas, sausage, watermelon). - ğ“¬ğ“˜ğ“®ğ“²ğ“Ÿ (pascÃ©)
cut with. - ğ“£ğ“¤ğ“˜ğ“®ğ“Ÿ (Ã­kaase)
cut with a sharp edge. - ğ“¬ğ“˜ğ“®ğ“Ÿ (pÃ¡se)
cutthroat. - ğ“¬ğ“˜ğ“¬ğ“˜ğ“¸ğ“ªÍ˜ (hpÃ¡paxÇ«)
cutting, cut (noun). - ğ“·ğ“˜ğ“¬ğ“˜ğ“®ğ“Ÿ (wÃ¡paase)
cutting: by ~. - ğ“¬ğ“˜- (pÃ¡-)
cyclone. - ğ“°ğ“˜ğ“²ğ“Ÿ ğ“ªğ“¡ğ“Ÿğ“®ğ“˜ğ“»ğ“£ (htaacÃ© Ã³hesaÅ¾i)
daily. - ğ“¡ğ“˜Í˜ğ“¬ğ“˜ ğ“ºğ“˜ğ“©ğ“£ (hÃ¡Ì¨Ä…pa zÃ¡ani)
damage one's reputation or standing by doing something inappropriate. - ğ“£ğ“§ğ“˜ğ“©ğ“˜Í˜ (Ã­lanÄ…)
damaging. - ğ“·ğ“Ÿğ“¬ğ“£ğ“»ğ“£ (wÃ©hpiiÅ¾i)
damp. - ğ“°ğ“ªğ“¤ğ“˜ (toohkÃ¡)
dance (noun, verb). - ğ“·ğ“˜ğ“²ğ“£ (waachÃ­)
dance: he duska ~ (name of a Ponca dance). - ğ“¡ğ“Ÿ ğ“µğ“¶ğ“¯ğ“¤ğ“˜ (hÃ© Ã°ÃºÅ¡ka)
dance: mourning ~. - ğ“·ğ“˜ğ“¯ğ“˜ğ“¬ğ“Ÿ ğ“˜ğ“µğ“£Í˜ (waÅ¡Ã¡pe aÃ°Ä¯)
dance: night ~. - ğ“¬ğ“˜ğ“ºğ“Ÿ ğ“·ğ“˜ğ“²ğ“£ (hpÃ¡ze waachÃ­)
dance: soldier ~. - ğ“˜ğ“¤ğ“£ğ“°ğ“˜ğ“©ğ“˜Í˜ğ“»ğ“£Í˜ ğ“·ğ“˜ğ“²ğ“£ (Ã¡hkitanÃ¡Ì¨Ä…Å¾Ä¯ waachÃ­)
dance: solo ~ by one who has been in a war. - ğ“·ğ“˜ğ“¯ğ“ªğ“¯ğ“Ÿ ğ“˜ğ“²ğ“£ ğ“©ğ“˜Í˜ğ“»ğ“£Í˜ (waÅ¡Ã³Å¡e achÃ­ nÄ…Ä…Å¾Ä¯)
dance arbor. - ğ“˜ğ“²ğ“£ğ“°ğ“˜Í˜ (Ã¡hcihtÄ…)
dance for. - ğ“˜ğ“·ğ“˜ğ“²ğ“£ (Ã¡waachi)
dance place or location. - ğ“ªğ“·ğ“˜ğ“²ğ“£ (Ã³waachi)
dances: ~ (war dances or ceremonial dances of the Osages). - ğ“£ğ“§ğ“ªÍ˜ğ“¯ğ“¤ğ“˜ (ilÃ³Ì¨Ç«Å¡ka)
dancing songs: sing ~, singers of dancing songs. - ğ“¸ğ“ªğ“¤ğ“˜ (xÃ³hka)
dare not: I ~. - ğ“˜Ì¨ğ“»ğ“ªÍ˜ ğ“µğ“£Í˜ğ“¤ğ“Ÿ (Ã¡Ì¨Å¾Ç« Ã°Ä¯kÃ©)
dark. - ğ“¡ğ“˜Í˜ğ“£Í˜ğ“©ğ“£Í˜ (hÃ¡Ì¨Ä¯nÄ¯)
dark: become or get ~. - ğ“¡ğ“˜Í˜ğ“©ğ“˜ğ“¬ğ“˜ğ“ºğ“Ÿ (hÃ¡Ì¨Ä…nahpazÃ©)
dark (in color). - ğ“¯ğ“˜ğ“¬ğ“Ÿ (Å¡Ã¡pe)
dark night. - ğ“¡ğ“˜Í˜ğ“©ğ“˜ğ“¬ğ“˜ğ“ºğ“Ÿ (hÃ¡Ì¨Ä…nahpazÃ©)
darken. - ğ“¡ğ“˜Í˜ğ“©ğ“˜ğ“¬ğ“˜ğ“ºğ“Ÿ (hÃ¡Ì¨Ä…nahpazÃ©)
darkened. - ğ“¯ğ“˜ğ“¬ğ“Ÿ (Å¡Ã¡pe)
darkness. - ğ“¡ğ“˜Í˜ğ“£Í˜ğ“©ğ“£Í˜ (hÃ¡Ì¨Ä¯nÄ¯)
darkness of night. - ğ“¡ğ“˜Í˜ğ“©ğ“˜ğ“¬ğ“˜ğ“ºğ“Ÿ (hÃ¡Ì¨Ä…nahpazÃ©)
date (be in a courtship with). - ğ“»ğ“ªğ“§ğ“Ÿ (Å¾Ã³le)
dative prefix. - ğ“¤ğ“£- (ki-)
daughter: babe ~. - ğ“˜ğ“®ğ“£ğ“¬ğ“˜ (asÃ­hpa)
daughter: first (eldest) ~. - ğ“¨ğ“£ğ“©ğ“˜ (mÃ­ina), ğ“·ğ“˜ğ“¤'ğ“ªğ“¬ğ“˜ (wakË€Ã³hpa), ğ“·ğ“˜ğ“¤'ğ“ªğ“°ğ“˜Í˜ (wakË€Ã³htÄ…)
daughter: fourth ~ (or subsequent daughter). - ğ“˜ğ“®ğ“£ğ“»ğ“£Í˜ (asÃ­Å¾Ä¯)
daughter: second ~. - ğ“·ğ“£ğ“¡ğ“Ÿ (wihÃ©)
daughter: third ~. - ğ“˜ğ“®ğ“£Í˜ğ“¤ğ“˜ (asÃ­Ì¨ka)
daughter (without reference to age) 'my daughter', 'your daughter', 'his/her daughter'. - ğ“·ğ“£ğ“»ğ“ªÍ˜ğ“¤ğ“Ÿ (wiÅ¾Ã³Ì¨ke), ğ“µğ“£ğ“»ğ“ªÍ˜ğ“¤ğ“Ÿ (Ã°iÅ¾Ã³Ì¨ke), ğ“£ğ“»ğ“ªÍ˜ğ“¤ğ“Ÿ (iÅ¾Ã³Ì¨ke)
daughter-in-law 'my daughter-in-law', 'your daughter-in-law', 'his/her daughter in law'. - ğ“·ğ“£ğ“²ğ“£ğ“©ğ“£ (wihcÃ­ni), ğ“µğ“£ğ“²ğ“£ğ“©ğ“£ (Ã°ihcÃ­ni), ğ“£ğ“²ğ“£ğ“©ğ“£ :Â¨ ğ“¨ğ“£ğ“˜ğ“¹ğ“Ÿ (ihcÃ­ni :Â¨ mÃ­aÉ£e)
daughter name: second ~ (hcizo clan). - ğ“Ÿğ“©ğ“˜Ì¨ğ“°ğ“ªÍ˜ğ“£Í˜ğ“¬ğ“Ÿ (eenÃ¡Ì¨tÇ«Ä¯pe)
dawn. - ğ“¡ğ“ªÍ˜ğ“¬ğ“˜ğ“¡ğ“¶ (hÃ³Ì¨Ç«pahu), ğ“¨ğ“£Í˜ğ“¡ğ“¶ğ“µğ“Ÿ (mÃ­Ì¨Ä¯huÃ°e)
day. - ğ“¡ğ“˜Í˜ğ“¬ğ“˜ (hÃ¡Ì¨Ä…pa)
day: a ~ or two. - ğ“¡ğ“ªÍ˜ğ“¬ğ“˜ ğ“·ğ“£Í˜ğ“¸ğ“²ğ“£ ğ“µğ“ªÍ˜ğ“¬ğ“˜ ğ“°ğ“˜ ğ“¯ğ“¤ğ“£ (hÃ³Ì¨Ç«pa wÃ­Ì¨xci Ã°Ç«Ç«pÃ¡ hta Å¡ki)
day: last ~. - ğ“¡ğ“˜Í˜ğ“¬ğ“˜ ğ“ªğ“µğ“ªğ“¡ğ“˜ğ“¤ğ“Ÿ (hÃ¡Ì¨Ä…pa oÃ°Ã³hake)
day: this ~ some time back, this day back in time. - ğ“¡ğ“ªÍ˜ğ“¬ğ“˜ğ“£ ğ“¡ğ“˜ğ“¯ğ“£ğ“°ğ“˜ (hÇ«pÃ¡i haÅ¡Ã­hta)
day after tomorrow. - ğ“¤ğ“˜ğ“®ğ“£Í˜ ğ“¤ğ“ªğ“°ğ“˜ğ“¡ğ“˜ (kaasÃ­Ì¨ kootÃ¡ha)
day before yesterday. - ğ“¡ğ“˜Í˜ğ“¬ğ“˜ ğ“¤ğ“ªğ“°ğ“˜ğ“¡ğ“˜ ğ“²ğ“Ÿ (hÃ¡Ì¨Ä…pa kootÃ¡ha ce), ğ“®ğ“£ğ“°ğ“ªÍ˜ğ“£Í˜ ğ“¤ğ“ªğ“°ğ“˜ğ“¡ğ“˜ ğ“²ğ“Ÿ (sitÃ³Ì¨Ä¯ kootÃ¡aha ce)
daybreak. - ğ“¡ğ“ªÍ˜ğ“¬ğ“˜ğ“¡ğ“¶ (hÃ³Ì¨Ç«pahu), ğ“¨ğ“£Í˜ğ“¡ğ“¶ğ“µğ“Ÿ (mÃ­Ì¨Ä¯huÃ°e)
daylight, daylight: be ~. - ğ“¡ğ“ªÍ˜ğ“¬ğ“˜ğ“¡ğ“¶ (hÃ³Ì¨Ç«pahu), ğ“¡ğ“ªÍ˜ğ“¬ğ“˜ğ“®ğ“¤ğ“˜ğ“¡ğ“˜ (hÃ³Ì¨Ç«paskaha)
Daylight Approaches, It's Coming Daylight (personal name). - ğ“¡ğ“ªÍ˜ğ“¬ğ“˜ğ“¡ğ“¶ (hÃ³Ì¨Ç«pahu)
days to come: in ~. - ğ“£ğ“°ğ“ªÍ˜ğ“£Í˜ ğ“µğ“Ÿğ“¡ğ“˜ (ihtÃ³Ì¨Ä¯ Ã°Ã©ha)
dead: the ~. - ğ“²'ğ“Ÿ (cË€Ã©)
dead (e.g. a vegetable). - ğ“¸ğ“Ÿğ“¤ğ“˜ (xÃ©ka)
dead person. - ğ“²'ğ“Ÿ (cË€Ã©)
deaf. - ğ“©ğ“˜Í˜ğ“¹ğ“¶ğ“²ğ“Ÿğ“¸ğ“Ÿğ“¤ğ“˜ (nÄ…Ä…É£ÃºcexÃ©ka)
deal with. - ğ“µğ“¶ğ“²ğ“Ÿğ“¬ğ“Ÿ (Ã°uhcÃ©pe)
dear. - ğ“ªğ“¸ğ“°ğ“˜ (Ã³xta)
dear: hold each other ~. - ğ“µğ“ªğ“°ğ“˜ğ“¤ğ“£ğ“µğ“Ÿ (Ã°Ã³tahkiÃ°e)
dear: make ~. - ğ“ªğ“¸ğ“°ğ“˜ğ“¤ğ“£ğ“µğ“Ÿ (Ã³xtakiÃ°e)
death. - ğ“²'ğ“Ÿ (cË€Ã©), ğ“ªğ“¸ğ“£ğ“µğ“˜ (Ã³xiÃ°a)
death: be near ~. - ğ“£ğ“¬ğ“£ğ“»ğ“£ (Ã­hpiiÅ¾i)
debt. - ğ“·ğ“Ÿğ“¶ğ“ºğ“Ÿ (weÃºuze)
decade. - ğ“ªğ“¨ğ“˜Í˜ğ“£Í˜ğ“¤ğ“˜ ğ“§ğ“Ÿğ“œğ“˜Í˜ ğ“¡ğ“£ğ“Ÿğ“©ğ“˜Í˜ (omÃ¡Ì¨Ä¯hka lÃ©brÄ… hÃ­enÄ…)
deceitful: be ~ toward. - ğ“µğ“£ğ“¡ğ“£ğ“²ğ“Ÿ (Ã°iihÃ­ce)
deceive oneself. - ğ“¨ğ“˜Í˜ğ“¹ğ“£ğ“¤ğ“£ğ“µğ“Ÿ (mÄ…É£Ã­hkiÃ°e)
deceive someone - ğ“µğ“£ğ“¡ğ“£ğ“²ğ“Ÿ (Ã°iihÃ­ce), ğ“¨ğ“˜Í˜ğ“¹ğ“£ğ“µğ“Ÿ (mÄ…É£Ã­Ã°e)
December. - ğ“¨ğ“£Í˜ğ“ªÍ˜ğ“¬ğ“˜ ğ“˜ğ“§ğ“£Í˜ ğ“µğ“ªÍ˜ğ“¬ğ“˜ (mÃ­Ì¨Ä¯Ç«pa Ã¡lÄ¯Ä¯ Ã°Ç«Ç«pÃ¡), ğ“¨ğ“£Í˜ğ“ªÍ˜ğ“¬ğ“˜ ğ“·ğ“˜ğ“¤ğ“ªÍ˜ğ“°ğ“˜ ğ“£ğ“»ğ“£Í˜ğ“¤ğ“Ÿ ğ“£ğ“°ğ“˜ğ“Ÿ ğ“Ÿğ“¤ğ“£ğ“°ğ“¸ğ“˜Í˜ (mÃ­Ì¨Ä¯Ç«pa wahkÃ³Ì¨ta iÅ¾Ã­Ì¨ke iitÃ¡e Ã©kitxÄ…), ğ“·ğ“˜ğ“®ğ“˜ğ“¬ğ“Ÿ ğ“£ğ“°ğ“˜ğ“£ğ“¬ğ“£ (wasÃ¡pe iitÃ¡ipi)
decide. - ğ“·ğ“˜ğ“µğ“£ğ“§ğ“˜Í˜ ğ“¤ğ“˜ğ“¹ğ“Ÿ (waÃ°Ã­lÄ… kÃ¡aÉ£e)
decide for oneself. - ğ“·ğ“˜ğ“µğ“£ğ“§ğ“˜Í˜ ğ“¤ğ“£ğ“¤ğ“˜ğ“¹ğ“Ÿ (waÃ°Ã­lÄ… hkihkÃ¡aÉ£e)
deck of cards. - ğ“°ğ“˜ğ“©ğ“˜Ì¨ğ“¤'ğ“˜ ğ“µğ“£ğ“¡ğ“£ğ“²ğ“Ÿ (htanÃ¡Ì¨kË€a Ã°iihÃ­ce), ğ“°ğ“˜ğ“©ğ“˜Ì¨ğ“¤'ğ“˜ ğ“¤Ë€ğ“ªÍ˜ (htanÃ¡Ì¨kË€a kË€Ç«)
declarative sentence-final marker. - ğ“µğ“Ÿ (Ã°e)
decomposed. - ğ“°ğ“ªğ“»ğ“˜ğ“µğ“Ÿ (toÅ¾Ã¡Ã°e)
decrease (transitive). - ğ“ğ“ªğ“¬ğ“˜ ğ“Ÿğ“¤ğ“ªÍ˜ ğ“¤ğ“˜ğ“¹ğ“Ÿ (ÄÃ³opa ekÃ³Ì¨ kÃ¡aÉ£e)
deduce: I ~ that. - ğ“®ğ“¤ğ“˜ (ska)
deed (act). - ğ“ªğ“¤'ğ“˜Í˜ (Ã³kË€Ä…)
deed (document). - ğ“°ğ“˜ğ“©ğ“˜Ì¨ğ“¤'ğ“˜ (htanÃ¡Ì¨kË€a)
deep. - ğ“¯ğ“¤ğ“ªğ“¬ğ“Ÿ (Å¡kÃ³pe)
deer. - ğ“°ğ“˜ (htÃ¡a)
deer: female ~. - ğ“°ğ“˜ ğ“¨ğ“£Í˜ğ“¤ğ“˜ (htÃ¡a mÃ­Ì¨Ä¯ka)
deer: male ~. - ğ“°ğ“˜ ğ“°ğ“˜Ì¨ğ“¤ğ“˜ (htÃ¡a htÃ¡Ì¨ka)
Deer clan. - ğ“°ğ“˜ğ“©ğ“£ğ“¤ğ“˜ğ“¯ğ“£ (htÃ¡anihkÃ¡Å¡i)
deer mating moon (October). - ğ“°ğ“˜ ğ“¤ğ“£ğ“µğ“£ğ“¹ğ“Ÿğ“¬ğ“£ (htÃ¡a hkiÃ°Ã­É£epi)
deerskin. - ğ“°ğ“˜ğ“¡ğ“˜ (htaahÃ¡a)
defeat others (in a game or contest). - ğ“ªğ“¡ğ“£ (Ã³hi)
defecate. - ğ“»ğ“Ÿ (Å¾Ã©)
define as. - ğ“µğ“˜ğ“²ğ“Ÿ (Ã°aacÃ©)
deflated. - ğ“°ğ“ªğ“»ğ“Ÿ (tÃ³Å¾e)
defraud someone - ğ“¨ğ“˜Í˜ğ“¹ğ“£ğ“µğ“Ÿ (mÄ…É£Ã­Ã°e)
Delaware (tribe or tribal member). - ğ“·ğ“˜ğ“¬ğ“˜ ğ“©ğ“£ğ“¤ğ“˜ (wÃ¡pa nÃ­hka)
deliberate over. - ğ“˜ğ“·ğ“˜ğ“µğ“£ğ“§ğ“˜Í˜ (Ã¡waÃ°ilÄ…)
demented. - ğ“²'ğ“Ÿğ“¤ğ“˜ (cË€Ã©ka), ğ“¬ğ“¸ğ“˜ğ“µğ“˜ğ“»ğ“£ (pxÃ¡Ã°aÅ¾i)
demented person. - ğ“¬ğ“¸ğ“˜ğ“µğ“˜ğ“»ğ“£ (pxÃ¡Ã°aÅ¾i), ğ“·ğ“˜ğ“µğ“£ğ“§ğ“˜Í˜ ğ“Ÿğ“¤ğ“ªÍ˜ ğ“£Í˜ğ“¤ğ“Ÿ (waÃ°Ã­lÄ… eekÃ³Ì¨ Ä¯kÃ©)
denude. - ğ“µğ“¶ğ“¯ğ“˜ğ“¤ğ“Ÿ (Ã°uuÅ¡Ã¡ake), ğ“µğ“¶ğ“¯ğ“˜ğ“·ğ“£Í˜ (Ã°uuÅ¡Ã¡wÄ¯), ğ“µğ“¶ğ“¯ğ“°ğ“˜ (Ã°uuÅ¡tÃ¡)
depart. - ğ“˜ğ“µğ“Ÿ (aÃ°Ã©e), ğ“ªğ“¤ğ“˜ğ“œğ“˜ (okÃ¡bra)
depend on. - ğ“£ğ“¤ğ“£ğ“©ğ“˜ğ“»ğ“£ (Ã­kinaaÅ¾i)
desire (verb). - ğ“¤ğ“ªÍ˜ğ“µğ“˜ (kÃ³Ì¨Ã°a)
despair (verb). - ğ“¤ğ“£ğ“¸ğ“£ğ“µğ“˜ (hkÃ­xiÃ°a)
despicable. - ğ“£ğ“®ğ“Ÿğ“·ğ“˜ğ“µğ“Ÿ (iisÃ©waÃ°e)
despise. - ğ“£ğ“®ğ“£ (Ã­isi)
despite: have one's way ~ something - ğ“ªğ“µğ“˜Í˜ğ“»ğ“£ (Ã³Ã°Ä…Å¾i)
despite the odds. - ğ“ªğ“µğ“˜Í˜ğ“»ğ“£ (Ã³Ã°Ä…Å¾i)
despondent. - ğ“¤ğ“£ğ“ºğ“ªğ“»ğ“£ (kÃ­zoÅ¾i)
dessert. - ğ“·ğ“˜ğ“®ğ“¤ğ“¶ğ“Ÿ (waskÃºe)
destructive. - ğ“°ğ“˜ğ“µğ“¶ğ“¬ğ“£ğ“»ğ“£ (taaÃ°ÃºhpiiÅ¾i), ğ“·ğ“Ÿğ“¬ğ“£ğ“ºğ“£ÌŒğ“£ (wÃ©hpiiziÌŒi)
detain someone who is passing by. - ğ“©ğ“˜Í˜ğ“»ğ“£Í˜ (nÄ…Ä…Å¾Ã­Ì¨)
detect something (without getting full knowledge of it). - ğ“ªğ“¬ğ“Ÿğ“©ğ“£ (opÃ©ni)
detergent. - ğ“·ğ“Ÿğ“¬ğ“¶ğ“¤ğ“¸ğ“˜ (wÃ©pukxa)
detergent: dish ~. - ğ“¡ğ“£Í˜ğ“²ğ“Ÿ ğ“£ğ“µğ“¶ğ“»ğ“˜ ğ“·ğ“Ÿğ“¬ğ“¶ğ“¤ğ“¸ğ“˜ (hÃ­Ì¨Ä¯ce Ã­Ã°uuÅ¾a wÃ©pukxa)
determinde. - ğ“©ğ“£ğ“¤ğ“˜ ğ“·ğ“˜ğ“»ğ“£Í˜ğ“°ğ“˜Í˜ (nÃ­hka waÅ¾Ã­Ì¨htÄ…Ä…), ğ“·ğ“˜ğ“»ğ“£Í˜ ğ“£ğ“°ğ“˜ (waÅ¾Ã­Ì¨ ihta)
determinedly. - ğ“·ğ“˜ğ“»ğ“£Í˜ ğ“£ğ“°ğ“˜ (waÅ¾Ã­Ì¨ ihta)
determined person. - ğ“©ğ“£ğ“¤ğ“˜ ğ“·ğ“˜ğ“»ğ“£Í˜ğ“°ğ“˜Í˜ (nÃ­hka waÅ¾Ã­Ì¨htÄ…Ä…)
detest. - ğ“£ğ“®ğ“£ (Ã­isi)
detestible. - ğ“£ğ“¯ğ“Ÿğ“·ğ“˜ğ“µğ“Ÿ (iiÅ¡Ã©waÃ°e)
detour around something - ğ“£ğ“µğ“£ğ“¯ğ“˜Í˜ğ“¡ğ“˜ (Ã­Ã°iÅ¡Ä…ha)
devil. - ğ“²'ğ“˜ ğ“°ğ“˜Í˜ (cË€Ã¡ htÃ¡Ì¨Ä…), ğ“£ğ“§ğ“ªÍ˜ğ“¹ğ“Ÿ (ilÃ³Ì¨É£e)
devoid: be ~ of. - ğ“µğ“£Í˜ğ“¤ğ“Ÿ (Ã°Ä¯kÃ©)
devour. - ğ“µğ“˜ğ“©ğ“£Í˜ (Ã°aanÃ­Ì¨Ä¯)
dew. - ğ“¸ğ“Ÿğ“¨ğ“˜Í˜ğ“¤ğ“Ÿ (xÃ©mÄ…ke)
Dhegiha. - ğ“µğ“Ÿğ“¤ğ“£ğ“¡ğ“˜ (Ã°eekÃ­ha)
diabetes, suffer from diabetes. - ğ“»ğ“˜Í˜ğ“©ğ“£ğ“Ÿ ğ“·ğ“˜ğ“¬ğ“Ÿğ“£Í˜ ğ“¡ğ“¶ğ“¤ğ“ªÍ˜ğ“µğ“˜ ğ“ªğ“»ğ“¶ (Å¾Ä…Ä…nÃ­e wapeÃ­Ì¨ huukÃ³Ì¨Ã°a Ã³oÅ¾u)
diamonds (suit in a deck of cards). - ğ“¬ğ“Ÿ ğ“µğ“˜ğ“¡ğ“˜ (pÃ© Ã°aha)
diaper. - ğ“¡ğ“£ğ“µğ“˜ğ“¸ğ“˜ (hÃ­Ã°axa), ğ“¸ğ“£ğ“µğ“˜ğ“¸ğ“˜ (xÃ­Ã°axa)
diaphragm. - ğ“µğ“¶ğ“·ğ“Ÿ (Ã°Ãºwe)
dice (noun). - ğ“¤'ğ“ªÍ˜ğ“®ğ“¶ (kË€Ç«Ìsu)
dice: play ~. - ğ“¤'ğ“ªÍ˜ğ“®ğ“¶ğ“¤Ë€ğ“ªÍ˜ (kË€Ç«ÌsukË€Ç«Ì)
dice by cutting over and over. - ğ“¬ğ“˜ğ“®ğ“˜ğ“®ğ“˜ (paasÃ¡sa)
dice game. - ğ“¤'ğ“ªÍ˜ğ“®ğ“¶ğ“¤Ë€ğ“ªÍ˜ (kË€Ç«ÌsukË€Ç«Ì)
die (verb). - ğ“²'ğ“Ÿ (cË€Ã©), ğ“¸ğ“£ğ“µğ“˜ (xÃ­Ã°a)
die: make ~. - ğ“²'ğ“Ÿğ“µğ“Ÿ (cË€Ã©Ã°e)
different. - ğ“Ÿğ“»ğ“£ (Ã©eÅ¾i)
different kind: of a ~. - ğ“Ÿğ“»ğ“£ (Ã©eÅ¾i)
different one: a ~. - ğ“Ÿğ“»ğ“£ ğ“·ğ“£Í˜ (Ã©Å¾i wÄ¯)
different-looking. - ğ“Ÿğ“»ğ“£ğ“¸ğ“²ğ“£ (Ã©Å¾ixci)
difficult. - ğ“²ğ“Ÿğ“¸ğ“£ (hcÃ©xi), ğ“®ğ“˜ğ“¤ğ“£ (saakÃ­), ğ“·ğ“˜ğ“²ğ“Ÿğ“¸ğ“£ (wahcÃ©xi)
Difficult Female (name for a first daughter). - ğ“¨ğ“£Í˜ğ“²ğ“Ÿğ“¸ğ“£ (mÄ¯Ä¯hcÃ©xi)
dig, dig up. - ğ“¤'ğ“Ÿ (kË€Ã©)
dig (e.g., a grave). - ğ“¬ğ“˜ğ“¤'ğ“ª (paakË€Ã³)
dime. - ğ“·ğ“˜ğ“µğ“˜ğ“·ğ“˜ ğ“§ğ“Ÿğ“œğ“˜Í˜ (waÃ°Ã¡awa lÃ©brÄ…)
diminish someone by slandering, maligning, or belittling him or her. - ğ“¤ğ“£ğ“§ğ“˜ğ“»ğ“ªğ“»ğ“£ (hkilÃ¡aÅ¾oÅ¾i)
dine. - ğ“·ğ“˜ğ“©ğ“ªÍ˜ğ“œğ“Ÿ (wanÇ«Ìbre)
dine outdoors. - ğ“˜ğ“¯ğ“£ğ“°ğ“˜ ğ“·ğ“˜ğ“©ğ“ªÍ˜ğ“œğ“Ÿ (Ã¡Å¡ihta wanÇ«Ìbre)
dingy. - ğ“¯ğ“ªğ“²ğ“Ÿ (Å¡Ã³ce)
dinner (meal served at noon or in the evening). - ğ“¨ğ“£Í˜ğ“µğ“ªğ“°ğ“˜ ğ“·ğ“˜ğ“©ğ“ªÍ˜ğ“œğ“Ÿ (mÄ¯Ä¯Ã°Ã³hta wanÇ«Ìbre), ğ“ªğ“©ğ“ªÍ˜rğ“Ÿ (Ã³nÇ«re), ğ“·ğ“˜ğ“©ğ“ªÍ˜ğ“œğ“Ÿ (wanÇ«Ìbre)
dinner bell. - ğ“£ğ“¤ğ“˜ğ“°ğ“˜ğ“¨ğ“˜Í˜ (Ã­ikaahtamÄ…)
dinnerware (e.g., a set of plates, cups, and bowls). - ğ“²ğ“Ÿğ“¡ğ“Ÿğ“»ğ“£Í˜ (hcÃ©heÅ¾Ä¯)
dipper. - ğ“©ÌŒğ“£ğ“µğ“˜ğ“°ğ“˜Í˜ (nÌŒÃ­iÃ°aahtÄ…)
direction: in a ~. - ğ“¡ğ“˜ (ha)
direction: in that ~. - ğ“Ÿ ğ“°ğ“˜ğ“¡ğ“˜ (Ã©e htÃ¡ha)
direction: in the ~ of. - ğ“Ÿ ğ“°ğ“˜ğ“¡ğ“˜ (Ã©e htÃ¡ha), ğ“°ğ“˜ (hta), ğ“°ğ“˜ğ“¡ğ“˜ (htÃ¡ha)
direction: in the other ~. - ğ“˜ğ“¨ğ“˜Í˜ğ“°ğ“˜ğ“¡ğ“˜ (Ã¡mÄ…htaha)
direction: that ~. - ğ“Ÿğ“¨ğ“˜Í˜ğ“°ğ“˜ (Ã©mÄ…hta)
dirt. - ğ“¨ğ“˜Í˜ğ“£Í˜ğ“¤ğ“˜ (mÃ¡Ì¨Ä¯hka)
dirt: cover with ~. - ğ“˜ğ“µğ“£ğ“¤'ğ“ª (Ã¡Ã°ikË€o)
dirty (sick, evil). - ğ“£ğ“ºğ“£ğ“ºğ“£ğ“¤ğ“Ÿ (Ã­zizike)
dirty (unclean). - ğ“·ğ“˜ğ“¤ğ“˜ğ“§ğ“˜Í˜ (wÃ¡kalÄ…), ğ“·ğ“˜ğ“®ğ“¶ğ“¡ğ“¶ğ“»ğ“£ (wasÃºhuÅ¾i)
dirty something - ğ“£ğ“ºğ“£ğ“ºğ“£ğ“¤ğ“Ÿ ğ“¤ğ“˜ğ“¹ğ“Ÿ (Ã­zizike kÃ¡aÉ£e)
disagree, disagree with. - ğ“£ğ“©ğ“˜Í˜ğ“¡ğ“£ğ“»ğ“£ (iinÄ…ÌhiÅ¾i)
disallow. - ğ“£ğ“»ğ“ªğ“¯ğ“£ (Ã­Å¾oÅ¡i)
disband. - ğ“ªğ“¤ğ“˜ğ“œğ“˜ (okÃ¡bra), ğ“¬ğ“˜ğ“©ğ“˜ (panÃ¡a)
discard (verb). - ğ“ªÍ˜ğ“µğ“Ÿ (Ç«ÌÇ«Ã°e)
discard someone or something - ğ“ªÍ˜ğ“µğ“˜ (Ç«ÌÇ«Ã°a)
discern something - ğ“£ğ“¤ğ“£ğ“µğ“Ÿ (Ã­ikiÃ°e)
disconsolate. - ğ“¤ğ“£ğ“ºğ“ªğ“»ğ“£ (kÃ­zoÅ¾i)
discouraged: become ~. - ğ“¤ğ“£ğ“¸ğ“£ğ“µğ“˜ (hkÃ­xiÃ°a)
discover in part but not fully. - ğ“ªğ“¬ğ“Ÿğ“©ğ“£ (opÃ©ni)
discover something - ğ“£ğ“¤ğ“£ğ“µğ“Ÿ (Ã­ikiÃ°e)
discuss. - ğ“£ğ“Ÿ (Ã­e), ğ“ªğ“£ğ“Ÿ (Ã³ie)
disease: venereal ~. - ğ“·ğ“˜ğ“²ğ“£ğ“©ğ“£ğ“Ÿ (wÃ¡cinie)
disgrace: be in ~. - ğ“£ğ“§ğ“˜ğ“©ğ“˜Í˜ (Ã­lanÄ…)
dish. - ğ“²ğ“Ÿğ“¡ğ“Ÿğ“»ğ“£Í˜ (hcÃ©heÅ¾Ä¯), ğ“¡ğ“£Í˜ğ“²ğ“Ÿ (hÃ­Ì¨Ä¯ce)
dish: flat and wide ~. - ğ“¡ğ“£Í˜ğ“²ğ“Ÿ ğ“œğ“˜ğ“¤ğ“˜ (hÃ­Ì¨Ä¯ce braaka)
dish soap, dish detergent. - ğ“¡ğ“£Í˜Ìğ“£Í˜ğ“²ğ“Ÿ ğ“£ğ“µğ“¶ğ“»ğ“˜ ğ“·ğ“Ÿğ“¬ğ“¶ğ“¤ğ“¸ğ“˜ (hÄ¯ÌÄ¯ce Ã­Ã°uuÅ¾a wÃ©pukxa)
dish towel. - ğ“¡ğ“£Í˜Ìğ“£Í˜ğ“²ğ“Ÿ ğ“£ğ“¬ğ“¶ğ“¤ğ“¸ğ“˜ (hÄ¯ÌÄ¯ce Ã­pukxa)
dishes (e.g., a set of plates, cups, and bowls). - ğ“²ğ“Ÿğ“¡ğ“Ÿğ“»ğ“£Í˜ (hcÃ©heÅ¾Ä¯)
disheveled. - ğ“¡ğ“Ÿğ“¸ğ“¬ğ“˜ (hÃ©xpa)
disinfect (e.g., a buffalo hide). - ğ“µğ“¶ğ“·ğ“˜ğ“®ğ“¶ (Ã°uuwÃ¡su)
dislike. - ğ“£ğ“®ğ“£ (Ã­isi)
dislike something - ğ“¤ğ“£ğ“¡ğ“ªÍ˜ğ“»ğ“£ (kihÇ«ÌÇ«Å¾i)
disliked. - ğ“£ğ“®ğ“Ÿğ“·ğ“˜ğ“µğ“Ÿ (iisÃ©waÃ°e)
disloyal person. - ğ“·ğ“˜ğ“·ğ“£Í˜Ìğ“¤ğ“¯ğ“˜ğ“»ğ“£ (wawÄ¯ÌkÅ¡aÅ¾i)
dismissed (as at the end of a school day): be ~. - ğ“¬ğ“˜ğ“©ğ“˜ (panÃ¡a)
dismount from (e.g., a horse). - ğ“ªğ“·ğ“£Ìğ“®ğ“£ (owiÌsi), ğ“·ğ“£ğ“®ğ“£ (wÃ­si)
disobey. - ğ“ªğ“¬ğ“¯ğ“˜Ìğ“»ğ“£ (opÅ¡aÌÅ¾i)
dispatch (verb). - ğ“µğ“Ÿ ğ“¤ğ“˜ğ“¹ğ“Ÿ (Ã°Ã©e kÃ¡aÉ£e)
disperse (transitive, intransitive). - ğ“ªğ“¤ğ“˜ğ“œğ“˜ (okÃ¡bra)
dispirited. - ğ“¤ğ“£ğ“ºğ“ªğ“»ğ“£ (kÃ­zoÅ¾i)
display (multiple items) on top of something else. - ğ“˜ğ“»ğ“¶ (Ã¡Å¾u)
disposition: having a bad ~. - ğ“ªğ“¤'ğ“˜Í˜ ğ“¬ğ“£ğ“»ğ“£ (Ã³kË€Ä… hpÃ­iÅ¾i)
disregard. - ğ“ªğ“µğ“˜Í˜ğ“²ğ“Ÿğ“¯ğ“£ ğ“µğ“£Í˜ğ“¤ğ“Ÿ (Ã³Ã°Ä…Ä…ceÅ¡i Ã°Ä¯kÃ©)
disrespectful. - ğ“·ğ“˜ğ“¤ğ“˜ğ“²'ğ“˜ğ“£ğ“»ğ“£ (wakaacË€Ã¡iÅ¾i)
dissect. - ğ“¬ğ“˜ğ“²ğ“Ÿ (hpÃ¡ce)
distant: be ~ (e.g., an estranged married couple). - ğ“¤ğ“£ğ“µğ“˜ğ“¡ğ“˜ğ“¬ğ“˜ (kÃ­Ã°ahapa)
distant (in space). - ğ“·ğ“Ÿğ“¡ğ“£ğ“²ğ“Ÿ (wÃ©hice)
distant in space or time. - ğ“¤ğ“ªğ“°ğ“šğ“¤ğ“Ÿ (kootÃ¡Ä¯ke)
distinct. - ğ“ªğ“¤ğ“˜Í˜ğ“²ğ“£ (ohkÄ…Ìci)
distant: make ~. - ğ“·ğ“˜ğ“µğ“˜ğ“®ğ“¤ğ“˜ (wÃ¡Ã°aaska)
distracted: be ~ by problems or sickness. - ğ“ªğ“¤ğ“˜ğ“¯ğ“Ÿ (Ã³kaÅ¡e)
distraught: be ~ from. - ğ“£ğ“¬ğ“£ğ“»ğ“£ (Ã­hpiiÅ¾i)
disturbance. - ğ“ªğ“²ğ“£ğ“»ğ“Ÿ (Ã³ochiÅ¾e)
disuse (verb). - ğ“ªğ“µğ“˜Í˜ğ“²ğ“Ÿğ“¯ğ“£ ğ“µğ“£Í˜ğ“¤ğ“Ÿ (Ã³Ã°Ä…Ä…ceÅ¡i Ã°Ä¯kÃ©)
ditch. - ğ“ªğ“¸ğ“Ÿ (Ã³xe)
ditch: small ~ around tipi for drainage. - ğ“©ğ“˜Í˜ğ“²ğ“Ÿğ“˜ğ“¡ğ“˜ (nÄ…Ìceaha)
divan. - ğ“˜ğ“§ğ“£Í˜Ìğ“£Í˜ğ“®ğ“²ğ“Ÿ (Ã¡lÄ¯ÌÄ¯scee), ğ“˜ğ“»ğ“˜Í˜ ğ“»ğ“£Í˜ğ“¤ğ“˜ (Ã¡Å¾Ä… Å¾Ä¯ka)
divest oneself of. - ğ“©ğ“£ğ“µğ“Ÿ (nÃ­Ã°e)
divide (verb). - ğ“£ğ“¤ğ“£ğ“§ğ“˜ğ“£ (Ã­hkilai), ğ“¤ğ“£ğ“µğ“˜ğ“¡ğ“˜ğ“¬ğ“˜ (kÃ­Ã°ahapa)
divide in two. - ğ“µğ“ªÍ˜ğ“¬ğ“˜ğ“¡ğ“˜ ğ“¤ğ“˜ğ“¹ğ“Ÿ (Ã°Ç«Ç«pÃ¡ha kÃ¡aÉ£e)
divided. - ğ“»ğ“˜ğ“°ğ“˜ (Å¾Ã¡hta)
divided: be ~. - ğ“¤ğ“£ğ“µğ“˜ğ“¡ğ“˜ğ“¬ğ“˜ (kÃ­Ã°ahapa)
divorce. - ğ“¤ğ“£ğ“ªÍ˜ğ“µğ“Ÿ (hkÃ­Ç«Ã°e), ğ“ªğ“¤ğ“£ğ“ªÍ˜ğ“µğ“Ÿ (ohkÃ­Ç«Ã°e)
divorce, be divorced. - ğ“¤ğ“£ğ“µğ“˜ğ“¡ğ“˜ğ“¬ğ“˜ (kÃ­Ã°ahapa)
divorced: become ~ from. - ğ“ªğ“¤ğ“£ğ“ªÍ˜ğ“µğ“Ÿ (ohkÃ­Ç«Ã°e)
dizzy. - ğ“£Í˜ğ“²ğ“Ÿ ğ“¬ğ“˜ğ“ºğ“Ÿ (Ä¯cÃ© hpÃ¡ze)
do. - ğ“Ÿğ“¤ğ“£ğ“ªÍ˜ (Ã©kiÇ«), ğ“Ÿğ“ªÍ˜ (Ã©Ç«), ğ“¤ğ“˜ğ“¹ğ“Ÿ (kÃ¡aÉ£e)
do (engage in an activity). - ğ“ªÍ˜ (Ç«Ì)
do for oneself. - ğ“¤ğ“£ğ“¤ğ“˜ğ“¹ğ“Ÿ (hkihkÃ¡aÉ£e)
do good works, do good. - ğ“µğ“˜ğ“§ğ“£Í˜ ğ“¤ğ“˜ğ“¹ğ“Ÿ (Ã°Ã¡alÄ¯ kÃ¡aÉ£e)
do harm to. - ğ“µğ“¶ğ“¬ğ“£ğ“»ğ“£ (Ã°uhpÃ­iÅ¾i)
do how/however, do in whatever way, do what about (indefinite). - ğ“¡ğ“˜ğ“ªÍ˜ (hÃ¡aÇ«)
do no more. - ğ“¤ğ“˜ğ“¤ğ“ªÍ˜ğ“©ğ“˜Í˜ ğ“¤ğ“˜ğ“¹ğ“Ÿ (kaakÇ«ÌnÄ… kÃ¡aÉ£e)
do nothing. - ğ“ªğ“¤ğ“˜ğ“¹ğ“ ğ“¤ğ“Ÿ (Ã³kaaÉ£eÄ¯ke)
do one's best. - ğ“£ğ“¤'ğ“¶ğ“²ğ“Ÿ (Ã­kË€uce), ğ“·ğ“˜ğ“¯ğ“¤ğ“˜Í˜ (waaÅ¡kÄ…Ì)
do oneself ill or harm. - ğ“¤ğ“£ğ“§ğ“¶ğ“¬ğ“£ğ“»ğ“£ (hkilÃºhpiiÅ¾i)
do over. - ğ“¤ğ“£ğ“¤ğ“˜ğ“¹ğ“Ÿ (kikÃ¡aÉ£e)
do something: make someone ~. - ğ“˜ğ“¤ğ“˜ğ“»ğ“£ (Ã¡kaaÅ¾i)
do something poorly. - ğ“ªğ“§ğ“˜Í˜ğ“»ğ“£ (oolÄ…ÌÄ…Å¾i)
do something to oneself. - ğ“Ÿğ“·ğ“˜ğ“¤ğ“£ğ“¤'ğ“ªÍ˜ (Ã©wahkikË€Ç«), ğ“Ÿğ“·ğ“˜ğ“¤ğ“£ğ“ªÍ˜ğ“µğ“Ÿ (Ã©wahkiÃ³Ì¨Ã°e)
do to oneself, do something to excess while paying no heed to others. - ğ“Ÿğ“¤ğ“£ğ“ªÍ˜ (Ã©hkiÇ«)
do what, do what with, do what about. - ğ“¡ğ“˜ğ“ªÍ˜ (hÃ¡aÇ«)
do whatever with, do whatever. - ğ“¡ğ“˜ğ“ªÍ˜ (hÃ¡aÇ«)
do work. - ğ“·ğ“˜ğ“µğ“£ğ“°ğ“˜Í˜ (waÃ°Ã­htÄ…)
docile. - ğ“·ğ“˜ğ“²'ğ“Ÿğ“¤ğ“˜ (wacË€Ã©ka)
doctor (noun), be a doctor. - ğ“·ğ“˜ğ“¤ğ“ªÍ˜ğ“°ğ“˜ğ“¤ğ“£ (wahkÇ«Ìtaki)
doctor someone - ğ“¯ğ“²ğ“Ÿğ“µğ“Ÿ (Å¡cÃ©Ã°e)
document (legal or otherwise). - ğ“°ğ“˜ğ“©ğ“˜Í˜ğ“¤'ğ“˜ (htanÄ…ÌkË€a)
document containing text. - ğ“·ğ“˜ğ“§ğ“Ÿğ“ºğ“Ÿ (walÃ©ze)
document of borrewed money. - ğ“¨ğ“˜Í˜ğ“ºğ“Ÿğ“®ğ“¤ğ“˜ ğ“ªğ“°ğ“˜ ğ“·ğ“˜ğ“§ğ“Ÿğ“ºğ“Ÿ (mÄ…Ìzeska ootÃ¡ walÃ©ze)
doe. - ğ“°ğ“˜ (htÃ¡a), ğ“°ğ“˜ ğ“¨ğ“£Í˜ğ“¤ğ“˜ (htÃ¡a mÃ­Ì¨Ä¯ka)
dog. - ğ“¯ğ“ªÍ˜ğ“¤ğ“Ÿ (Å¡Ç«ke)
dog: black ~. - ğ“¯ğ“ªÍ˜ğ“°ğ“˜Í˜ ğ“®ğ“˜ (Å¡Ç«htÄ…ÌÄ… sa)
dog: female ~. - ğ“¯ğ“ªÍ˜ğ“¨ğ“£Í˜Ìğ“£Í˜ğ“¤ğ“˜ (Å¡Ç«mÄ¯ÌÄ¯ka)
dogwood. - ğ“¨ğ“ªÍ˜ğ“®ğ“˜ ğ“¡ğ“¶ (mÇ«ÌÇ«sa hu)
"doings": have a ~. - ğ“ªğ“¤'ğ“˜Í˜ (Ã³kË€Ä…)
dollar. - ğ“œğ“ªğ“¤ğ“˜ (brÃ³ka)
dolled up. - ğ“£ğ“¯ğ“Ÿğ“·ğ“˜ğ“£ (Ã­iÅ¡ewai)
don (as clothing). - ğ“ªğ“¬ğ“˜ğ“¡ğ“˜Í˜ (opÃ¡ahÄ…)
done (cooked). - ğ“²ğ“¶ğ“²ğ“Ÿ (cÃºuce)
donkey. - ğ“©ğ“˜Í˜ğ“°ğ“˜Í˜ğ“°ğ“˜Í˜ (nÄ…Ä…htÄ…ÌhtÄ…Ä…)
door. - ğ“²ğ“£ğ“»ğ“Ÿ (hciÅ¾Ã©)
doorbell: ring or press the ~. - ğ“µğ“¶ğ“¤ğ“˜ğ“¨ğ“˜Í˜ (Ã°uuhkÃ¡amÄ…)
doorway. - ğ“²ğ“£ğ“»ğ“Ÿğ“¬ğ“Ÿ (hciÅ¾Ã©pe)
dotted button-snake-root, dotted gay feather (Liatris punctata). - ğ“¨ğ“˜Í˜ğ“¤ğ“˜ ğ“®ğ“˜ğ“¤ğ“£ (mÄ…hkÃ¡ saakÃ­)
dotted with small dots. - ğ“§ğ“Ÿğ“»ğ“Ÿ (lÃ©Å¾e)
doubt (verb). - ğ“·ğ“˜ğ“»ğ“˜ (waÅ¾Ã¡)
doubt oneself. - ğ“¤ğ“£ğ“¸ğ“£ğ“µğ“˜ (hkÃ­xiÃ°a)
down, downward. - ğ“¡ğ“¶ğ“²ğ“Ÿ (hÃºuce), ğ“¨ğ“˜Í˜ğ“§ğ“Ÿ (mÄ…Ìle)
down: go ~ (as a road). - ğ“ªğ“¬ğ“¸ğ“˜Ì¨ (opxÃ¡Ì¨)
down: go ~ (e.g., the sun when setting). - ğ“¬ğ“˜ğ“¬ğ“ª (papÃ³)
down: put or set ~. - ğ“¤ğ“£ğ“²ğ“Ÿğ“µğ“Ÿ (hkÃ­cheÃ°e)
down: take ~. - ğ“µğ“¶ğ“¡ğ“¶ğ“²ğ“Ÿ (Ã°uuhÃºuce), ğ“µğ“¶ğ“¸ğ“¬ğ“˜ğ“·ğ“£Í˜ (Ã°uxpÃ¡wÄ¯)
downcast. - ğ“¤ğ“£ğ“ºğ“ªğ“»ğ“£ (kÃ­zoÅ¾i)
drag. - ğ“µğ“£ğ“¹ğ“ª (Ã°iiÉ£o), ğ“µğ“£ğ“°ğ“˜Í˜ (Ã°iitÄ…Ì)
draw water (e.g., in a bathtub). - ğ“µğ“£ğ“¸ğ“°ğ“˜Í˜ (Ã°ixtÄ…Ì), ğ“µğ“¶ğ“ºğ“Ÿ (Ã°uuzÃ©)
dream (noun, verb), have a dream. - ğ“¡ğ“ªÍ˜ğ“œğ“Ÿ (hÇ«Ìbre)
dream: bad ~. - ğ“ªğ“¬ğ“˜ğ“ºğ“˜ (ohpÃ¡za)
dress (noun). - ğ“¡ğ“˜ğ“®ğ“¤ğ“˜ (haaskÃ¡), ğ“·ğ“Ÿğ“¤ğ“£ğ“§ğ“£Í˜ (wÃ©hkilÄ¯)
dress in. - ğ“£ğ“·ğ“Ÿğ“¤ğ“£ğ“§ğ“£Í˜ (Ã­wehkilÄ¯), ğ“ªğ“¤ğ“£ğ“ªğ“§ğ“˜Í˜ (Ã³hkioolÄ…Ì)
dress in. (e.g., a shirt or a dress). - ğ“ªğ“¤ğ“£ğ“ªğ“§ğ“˜Í˜ (Ã³hkioolÄ…Ì)
dress in clothing (not one's own). - ğ“·ğ“Ÿğ“¤ğ“£ğ“§ğ“£Í˜ ğ“ªğ“¬ğ“˜ğ“¡ğ“˜Í˜ (wÃ©hkilÄ¯ opÃ¡ahÄ…)
dress in one's own clothes. - ğ“·ğ“Ÿğ“¤ğ“£ğ“§ğ“£Í˜ ğ“ªğ“¤ğ“£ğ“¬ğ“˜ğ“¡ğ“˜Í˜ (wÃ©hkilÄ¯ okÃ­hpaahÄ…)
dress oneself. - ğ“ªğ“¤ğ“£ğ“ªğ“§ğ“˜Í˜ (Ã³hkioolÄ…Ì)
dress up in one's best attire. - ğ“£ğ“¯ğ“²ğ“Ÿğ“·ğ“˜ğ“£ (Ã­iÅ¡cewai)
dressed up. - ğ“£ğ“¯ğ“²ğ“Ÿğ“·ğ“˜ğ“£ (Ã­iÅ¡cewai)
dried. - ğ“¸ğ“Ÿğ“¤ğ“˜ (xÃ©ka)
dried corn. - ğ“ªğ“¡ğ“ªÍ˜ ğ“®ğ“˜ğ“¤ğ“£ (Ã³ohÇ« saakÃ­)
dried fruit. - ğ“¤ğ“˜Í˜ğ“²ğ“Ÿ ğ“¬ğ“¶ğ“ºğ“Ÿ (hkÄ…ÌÄ…ce pÃºze)
dried meat. - ğ“°ğ“˜ ğ“¬ğ“¶ğ“ºğ“Ÿ (htÃ¡a pÃºze)
dried squash. - ğ“·ğ“˜ğ“°ğ“¸ğ“˜Í˜ ğ“¬ğ“¶ğ“ºğ“Ÿ (watxÄ…Ì pÃºze)
dried up. - ğ“²ğ“¶ğ“¹ğ“Ÿ (hcÃºÉ£e)
drill: conduct a ~. - ğ“˜ğ“¤ğ“£ğ“°ğ“˜ ğ“ªğ“¤'ğ“˜Í˜ (Ã¡hkita okË€Ä…)
drink (verb). - ğ“µğ“˜ğ“°ğ“˜Í˜ (Ã°aahtÄ…Ì)
drink: soft ~. - ğ“©ğ“£ğ“¤ğ“˜ğ“¬ğ“¸ğ“ªğ“¤ğ“Ÿ (niikÃ¡apxohke)
drink alcohol. - ğ“·ğ“˜ğ“µğ“˜ğ“°ğ“˜Í˜ (waÃ°Ã¡ahtÄ…)
drink soup. - ğ“µğ“˜ğ“ºğ“¶ğ“¬ğ“Ÿ (Ã°aazÃºpe)
drink up. - ğ“µğ“˜ğ“©ğ“£Í˜Ìğ“£Í˜ (Ã°aanÄ¯ÌÄ¯)
drive (intransitive). - ğ“·ğ“˜ğ“¤ğ“˜ğ“»ğ“£ (wakÃ¡aÅ¾i)
drive (a vehicle). - ğ“¤ğ“˜ğ“»ğ“£ (kaaÅ¾Ã­)
drive (animals) - ğ“¨ğ“˜Í˜ğ“µğ“£Í˜Ì ğ“¤ğ“˜ğ“¹ğ“Ÿ (mÄ…Ã°Ä¯Ì kÃ¡aÉ£e)
drive around for pleasure . - ğ“ªğ“¬ğ“˜ğ“·ğ“£Í˜ğ“¹ğ“Ÿ (opÃ¡wÄ¯É£e)
drive for someone - ğ“¤ğ“£ğ“»ğ“£ (kÃ­Å¾i)
driver. - ğ“·ğ“˜ğ“µğ“£ğ“°ğ“˜Í˜ (waÃ°Ã­htÄ…), ğ“·ğ“˜ğ“¤ğ“˜ğ“»ğ“£ (wakÃ¡aÅ¾i), ğ“·ğ“˜ğ“¤ğ“˜ğ“»ğ“£ (wakÃ¡aÅ¾i)
drizzle (noun). - ğ“£ğ“¤ğ“£ğ“¯ğ“ªğ“²ğ“Ÿ (Ã­hkiÅ¡oce), ğ“©ğ“£ğ“¯ğ“ªğ“²ğ“Ÿ (nÃ­iÅ¡oce), ğ“©ğ“£ğ“»ğ“¶ ğ“¸ğ“ªğ“²ğ“Ÿ (niiÅ¾Ãº xÃ³ce), ğ“©ğ“£ğ“»ğ“¶ ğ“¸ğ“ªğ“°ğ“˜Í˜ (nÃ­iÅ¾u xohtÄ…)
droopy. - ğ“²'ğ“ªğ“¤ğ“˜ (cË€Ã³ka), ğ“¸ğ“¬ğ“Ÿğ“¤ğ“˜ (xpÃ©ka)
drop (e.g., an object or a comment into a conversation). - ğ“µğ“£ğ“¤ğ“¯ğ“£Í˜Ìğ“²ğ“Ÿ (Ã°ikÅ¡Ä¯Ìce)
drop feathers. - ğ“¬ğ“¶ğ“¤ğ“˜ğ“¯ğ“¤ğ“Ÿ (pÃºkaÅ¡ke), ğ“·ğ“˜ğ“¬ğ“£ğ“ªğ“¤ğ“˜ğ“¯ğ“¤ğ“Ÿ (wapÃ­okaÅ¡ke), ğ“·ğ“˜ğ“¬ğ“¶ğ“¯ğ“¤ğ“Ÿ (wapÃºÅ¡ke)
drop something into (e.g., eyedrops into eyes). - ğ“ªğ“µğ“£ğ“¤'ğ“Ÿ (oÃ°Ã­kË€e)
drub. - ğ“ªğ“²ğ“£Í˜Ì (ochÄ¯Ì)
druggist. - ğ“¨ğ“˜Í˜ğ“¤ğ“˜ ğ“˜ğ“µğ“£Í˜Ì (mÄ…hkÃ¡ aÃ°Ä¯Ì)
drum. - ğ“²ğ“Ÿğ“¹ğ“Ÿğ“©ğ“£ (cÃ©É£enii)
drum: pass the ~. - ğ“²ğ“Ÿğ“¹ğ“Ÿğ“©ğ“£ ğ“µğ“Ÿ ğ“¤ğ“˜ğ“¹ğ“Ÿ (cÃ©É£enii Ã°Ã©e kÃ¡aÉ£e)
drum tie the ~ (involves wrapping the drum up and tying it). - ğ“²ğ“Ÿğ“¹ğ“Ÿğ“©ğ“£ ğ“¤ğ“˜ğ“¹ğ“Ÿ (cÃ©É£enii kÃ¡aÉ£e)
drum boss. - ğ“²ğ“Ÿğ“¹ğ“Ÿğ“©ğ“£ ğ“ªğ“²ğ“£Í˜Ì (cÃ©É£enii ochÄ¯Ì)
